OBJECTID,BLOCKNUM,InternalFloorArea,FullTimeEmployees,PartTimeEmployees,TotalEmployees,Businesses,Shape__Area,Shape__Length
1,239,20057.401903,175,22,197,3,4.15040403822786e-06,0.0114472956306342
2,98,94800.7072661,2391,99,2490,50,5.29114004166331e-07,0.00317873207452398
3,97,121991.906742,2242,302,2544,129,9.54623828874901e-07,0.00391898878266069
4,96,129656.56172,1735,428,2163,144,9.81300672719954e-07,0.00396437523535311
5,39,151445.192788,3481,146,3627,38,7.23805896996055e-07,0.00352301447924607
6,38,16930.0807856,579,31,610,1,2.69169959210558e-07,0.00205773547495593
7,37,13588.588715,415,0,415,1,3.22718278766843e-07,0.00227319300150302
8,36,50510.8776161,1369,119,1488,154,3.49609763361514e-07,0.00258129754826182
9,35,117926.478029,4393,233,4626,39,9.62406375037972e-07,0.00400792079768846
10,34,146575.41982,2602,180,2782,37,1.26274062495213e-06,0.00477382637454464
11,33,25213.1651175,796,72,868,39,3.88594799005659e-07,0.00245942810678853
12,32,72825.8974801,213,251,464,8,8.52361608849606e-07,0.00385537162116922
13,31,123867.963087,4556,108,4664,51,7.97302163846325e-07,0.00387956472105929
14,30,53628.3903382,748,236,984,102,7.24106484994991e-07,0.00398946102652306
15,29,190094.271439,2900,416,3316,133,2.19092589759384e-06,0.00614387721941761
16,27,71023.4149075,944,120,1064,16,9.78115622274345e-07,0.0045111191038268
17,26,136534.777096,3409,205,3614,37,7.51509105612058e-07,0.00379697329752747
18,25,62764.1122055,469,110,579,6,5.48145635548281e-07,0.00343880144940304
19,24,6839.91557853,75,40,115,14,3.50867594534066e-07,0.00347679281851778
20,23,72351.2981295,313,54,367,24,2.17283741221763e-07,0.00212190352364311
21,22,61762.7031262,156,158,314,4,4.1555767893442e-07,0.0027648370442928
22,21,125112.589696,834,168,1002,40,1.68737687999965e-06,0.00873569046923317
23,20,26540.7448271,237,66,303,42,3.04631703329505e-06,0.0178175829894388
24,19,19122.9822279,360,137,497,41,7.63389834901318e-07,0.00405070484051251
25,18,35047.069762,850,77,927,35,8.56884071254171e-07,0.00483699567868314
26,17,6706.60492539,18,31,49,3,1.18893649414531e-06,0.00482120784481949
27,16,32619.0972967,364,178,542,31,1.37824235935113e-06,0.00544198029888889
28,15,18482.7857248,138,172,310,40,8.35837454360444e-07,0.00374071962987168
29,14,10332.3688083,65,48,113,9,5.53329755348386e-07,0.0040931249802055
30,13,4694.21810505,55,131,186,4,4.23149231210118e-07,0.00312572724750455
31,12,20750.8518363,305,138,443,15,2.71390263151261e-06,0.0106558200478638
32,161,93788.2141718,98,28,126,15,1.35155200950976e-05,0.0188798901893499
33,191,104991.347647,76,0,76,4,2.84171164821601e-06,0.0100491368478835
34,241,110257.566069,649,511,1160,105,1.16326978059078e-05,0.0305525591750627
35,606,15489.7954668,74,3,77,17,1.31220713228686e-06,0.00559011232962637
36,343,6654.22264041,24,17,41,7,5.11928647028981e-07,0.00304798351207421
37,342,7765.65396935,1,0,1,1,4.3419504436315e-07,0.00276095963689505
38,196,69799.1910798,324,44,368,42,1.42966882776818e-06,0.00493926848422241
39,195,12098.8876056,38,11,49,6,1.2602899914782e-06,0.00471003912039748
40,193,26294.8799299,17,0,17,9,1.20895811051014e-06,0.00486202296048885
41,192,22018.9158605,30,2,32,6,1.42467115438194e-06,0.00490561341136842
42,190,4271.41629127,5,1,6,2,1.21257062346558e-06,0.0084096619206514
43,189,23140.9844674,5,0,5,12,1.28577921714168e-05,0.0156933881545519
44,188,21376.4310121,100,0,100,8,1.93481582755339e-06,0.00550772044151763
45,95,109464.356973,1913,76,1989,56,1.94329550140537e-06,0.00545120615787714
46,94,65739.4416872,1150,107,1257,65,8.95564880920574e-07,0.00377761458087131
47,93,28323.9673586,118,39,157,14,4.84937572764466e-07,0.00295268596599576
48,92,7447.83098336,0,10,10,1,8.26245013740845e-07,0.00375603468773024
49,71,134862.407257,2704,166,2870,116,1.15594366434379e-06,0.0045644010446692
50,70,69672.9785492,1131,85,1216,196,5.88648163102334e-07,0.00379846409052891
51,69,89584.2919608,2981,141,3122,95,7.30412011762382e-07,0.00389451804539136
52,68,159858.508044,4273,260,4533,114,1.66822610481177e-06,0.00518343632346282
53,67,213325.578361,6441,280,6721,28,1.57273325385177e-06,0.00496469015663103
54,66,102940.417661,2955,431,3386,102,7.10799668013351e-07,0.00335519531833888
55,65,33585.312974,822,110,932,105,4.65281118522398e-07,0.00278577950624318
56,64,46974.9353426,825,89,914,44,4.51437699666712e-07,0.00289681815623652
57,63,41655.869904,1206,62,1268,87,4.86418230138952e-07,0.00285216310288094
58,62,100950.601443,2703,217,2920,85,8.92375283001456e-07,0.00465338127435972
59,61,179135.449862,4492,1084,5576,97,1.43348597703152e-06,0.00518372675110741
60,60,10535.1072959,149,106,255,9,6.12009444012074e-07,0.00427623293690547
61,59,149974.440461,2142,323,2465,18,4.84990505356109e-06,0.0111837168389667
62,58,137405.12471,3634,52,3686,59,8.97195604920853e-07,0.0038399165134777
63,57,57724.5885935,2730,1,2731,35,5.00766418554122e-07,0.00316872572314702
64,56,76792.3286896,2592,85,2677,46,5.86699570703786e-07,0.00338239476804508
65,55,238547.048551,6297,469,6766,321,1.75504919752711e-06,0.00529915979110794
66,54,230615.703781,5511,472,5983,362,1.98793441086309e-06,0.00570515160154929
67,53,145318.253131,3285,295,3580,192,1.26285840451601e-06,0.00527503946340647
68,52,23469.7498719,160,80,240,29,6.68720986141125e-07,0.0042540186093718
69,51,85548.5165476,1480,117,1597,112,7.52773757994873e-07,0.00383755662922166
70,50,82645.9520203,2296,380,2676,32,6.64820163365221e-07,0.00371744956160171
71,49,133879.340994,3246,54,3300,20,1.10205246528494e-06,0.00542350461044952
72,48,93804.3224402,3462,142,3604,46,7.1427712100558e-07,0.00486822362210679
73,47,45360.6398554,443,137,580,14,3.13940745400032e-07,0.00220050133121361
74,46,143545.81024,1988,336,2324,157,9.54961251409259e-07,0.00441411514859605
75,45,122528.806556,2995,410,3405,140,9.03739419300109e-07,0.00386946995363546
76,11,271099.970515,4763,406,5169,126,2.32464708460611e-06,0.00882185700486538
77,10,52110.1848034,81,43,124,20,6.08143136560102e-06,0.0117992676548822
78,9,27217.5600449,107,51,158,12,1.41733789860155e-06,0.00611565275562545
79,8,4304.27708042,159,0,159,4,2.66100414592074e-07,0.00263336358711196
80,7,7521.5709979,3,18,21,1,7.62857780500781e-07,0.00422595974701811
81,6,9016.0235422,207,66,273,4,2.24738414544845e-07,0.00185695187067228
82,5,61379.2330191,465,102,567,26,1.38033101393376e-06,0.00686652810646947
83,4,14216.6460054,1,19,20,2,9.5129416877171e-07,0.00529449386952833
84,2,17021.6482408,94,38,132,4,2.67240829998627e-06,0.00712762274398693
85,1,26763.2990077,12,5,17,5,1.80097777047195e-06,0.00833676530311416
86,799,4897.36261173,5,1,6,2,3.85467501473613e-07,0.00302978074631181
87,798,7766.6573086,15,4,19,3,5.09743586007971e-07,0.00300754134848623
88,727,8189.62250497,10,6,16,6,8.47545834403718e-07,0.00668898048172113
89,718,19955.9214145,38,56,94,17,2.63445099335513e-06,0.00723912014698986
90,717,19153.3879148,179,79,258,38,8.01345322543057e-07,0.00443793733968383
91,710,4754.74716011,19,7,26,1,3.72291196981678e-07,0.00295578276468737
92,687,8998.61968335,29,8,37,2,7.41694293537876e-07,0.00584749475425521
93,587,14802.9558351,48,13,61,15,1.23995459944126e-06,0.00702590459328135
94,523,75334.6815951,2822,49,2871,32,1.28410238176002e-06,0.00466904945014836
95,522,37929.4523565,43,8,51,11,3.67992470273748e-07,0.00344159601755019
96,521,20274.5654434,329,2,331,7,2.82273958873702e-07,0.00236379237579078
97,504,7928.20106643,2,4,6,1,6.44295596430311e-07,0.00388136093297718
98,501,3929.59554179,3,4,7,2,2.88555838778848e-07,0.00252805517513737
99,459,57269.1491097,467,138,605,12,2.2256313059188e-06,0.00590753220273811
100,458,22221.4511787,243,6,249,43,9.82542587735225e-07,0.00414241419220484
101,187,13179.025331,110,10,120,4,6.05936747888336e-07,0.0031648805951346
102,168,39363.3956438,337,60,397,2,2.48101696342928e-06,0.00860726117199149
103,167,21057.3926672,83,14,97,13,6.74149760016007e-07,0.00392174765507041
104,147,38860.9979739,1188,13,1201,23,5.73735633224715e-07,0.00328361534129227
105,145,217343.097578,461,96,557,101,1.24180178318056e-06,0.00443421622131683
106,133,12586.9936576,30,2,32,2,5.32795638719108e-07,0.00400111375660287
107,132,36001.7793453,99,27,126,11,4.56567249784712e-07,0.00307622623791979
108,131,59643.7324222,145,40,185,20,4.78137280879309e-07,0.0031858466718083
109,130,149251.188447,2713,97,2810,20,1.05787921711453e-06,0.00434000352129895
110,129,62230.6214672,703,91,794,43,8.27715666673612e-07,0.00391775736589759
111,128,61910.9182053,874,184,1058,3,5.71641976421233e-07,0.00346204158643786
112,127,139095.327133,2388,493,2881,116,1.11379495137953e-06,0.00429268541387003
113,126,410402.032099,4949,647,5596,201,1.88004378287587e-06,0.00549112304252383
114,125,118524.48325,2533,106,2639,55,9.09759364731144e-07,0.00493918436549433
115,124,175676.233709,4094,277,4371,115,1.55308271132526e-06,0.00552311188162211
116,123,31382.5124925,343,341,684,99,1.09585471363971e-06,0.00430799171700295
117,113,175214.885183,2336,502,2838,66,5.05967409480945e-06,0.0111093957405546
118,112,48170.3900517,81,89,170,11,2.07327307180094e-05,0.0274855773654194
119,110,27852.3953515,255,224,479,8,2.4806945475575e-06,0.0156876409023935
120,109,6408.75146278,19,5,24,4,8.00999805505853e-06,0.0110025329121797
121,108,17885.0794713,15,18,33,4,3.0754799809074e-06,0.00790167911537201
122,106,24514.1617917,79,1,80,3,1.55632915266324e-06,0.00486462667883305
123,105,9192.54464423,18,10,28,3,8.50540573082981e-06,0.0111195515474189
124,104,68024.7807564,203,58,261,4,8.85946428752504e-06,0.0128089895308752
125,103,25177.7882244,147,25,172,13,5.08067059854511e-05,0.0448861478924654
126,101,5213.88782191,23,3,26,11,3.98454085370759e-06,0.00776723368145466
127,100,30934.0252831,84,0,84,1,6.79823642713018e-07,0.00412066597185364
128,44,130931.647431,2488,79,2567,88,8.26130417408422e-07,0.00444846858615963
129,43,148792.176146,3216,436,3652,340,1.10365090222331e-06,0.00490171229297181
130,464,68089.6038856,448,94,542,18,6.50455149298068e-07,0.00313476007880966
131,463,7346.06661146,37,8,45,2,4.71457497042138e-07,0.00281797012858283
132,460,27993.1900587,106,10,116,12,6.34564003121341e-07,0.00390565705596873
133,462,9221.97404842,19,11,30,5,6.16091256233631e-07,0.00315488461399681
134,461,8399.62954382,6,2,8,2,2.91001470031915e-07,0.00221865469268087
135,457,20477.9644226,91,70,161,23,9.96381004370051e-07,0.00419262255305523
136,456,17421.5352796,83,16,99,13,1.00060196928098e-06,0.00421027038660442
137,455,15126.6061388,167,16,183,15,6.47003162157489e-07,0.00321185793042065
138,454,55194.4256265,165,115,280,33,9.35968728299486e-07,0.00465195321391972
139,453,8365.9022642,56,49,105,28,2.30770638154354e-07,0.00227064107134607
140,452,16748.8698686,139,27,166,38,5.86484020459466e-07,0.00311943578666951
141,451,8976.99952504,110,9,119,28,6.11706582276383e-07,0.00312936885301176
142,450,16810.9068031,35,8,43,6,9.71870576904621e-07,0.00416004988997214
143,449,17522.4641169,79,7,86,13,9.53284143179189e-07,0.00411711249371165
144,448,8632.49798056,12,4,16,3,9.2551636043936e-07,0.00405925597350255
145,447,12180.6506613,56,6,62,7,9.58023974817479e-07,0.00409489969533189
146,166,13105.542224,70,10,80,6,6.61971625959268e-07,0.00346054918281593
147,165,100053.050779,1774,411,2185,8,2.3642937776458e-06,0.00731320966779589
148,164,138859.360775,561,140,701,33,1.6389512893511e-06,0.00579771532471524
149,149,11106.6994405,140,65,205,20,2.82436303677969e-07,0.00242498087631562
150,163,7638.69828375,3,0,3,2,5.46518549526809e-07,0.00300072870110823
151,162,27322.2540411,611,11,622,4,1.12535508378642e-06,0.00490106436585397
152,160,41730.17684,0,5,5,2,7.12144810677273e-07,0.00396050981453243
153,159,20729.174244,80,105,185,21,5.33870661456604e-07,0.00336274688772774
154,158,37380.6729467,1409,6,1415,1,2.68711573880864e-07,0.00264955144853647
155,157,897.01648699,0,0,0,1,2.41378211285337e-06,0.00628466308370879
156,156,74905.7658795,2286,150,2436,29,5.74926161789335e-07,0.00313019582777845
157,155,35077.4954091,23,15,38,6,2.74923422693973e-07,0.00258398954017806
158,154,11267.2460216,101,82,183,32,2.71666067419574e-07,0.00256899592070551
159,153,62383.1506812,832,187,1019,66,1.10188057078631e-06,0.00470070072746229
160,152,16249.1261417,205,95,300,41,3.16574642056366e-07,0.00230561072677001
161,151,15665.2275044,203,83,286,47,2.04115167434793e-07,0.00190103045218988
162,141,23193.9795242,0,3,3,1,4.77196408610325e-07,0.00310741743230156
163,144,36218.2231064,279,192,471,69,6.98081294103758e-07,0.00377298819440529
164,142,8059.19804303,74,69,143,18,3.48702997143846e-07,0.00239489209004992
165,140,86312.5363473,1742,179,1921,73,1.12959378384403e-06,0.00519505835824244
166,139,32077.8901897,279,164,443,99,8.34474121802486e-07,0.0043956774681974
167,138,13089.4245485,298,112,410,123,3.68451310350792e-07,0.00236980331885798
168,137,24381.360051,347,160,507,111,5.68779341847403e-07,0.00313723039199656
169,136,29479.4733725,127,199,326,36,7.08855623088311e-07,0.00371769194307383
170,135,7186.66782061,53,12,65,24,1.15048806037521e-07,0.00148099065356661
171,134,27325.2306687,38,4,42,2,1.98868337975e-06,0.00557528210067107
172,122,53575.3941136,76,142,218,16,3.40316546498798e-07,0.00292013739958878
173,121,112048.917214,3220,132,3352,48,7.34271452529356e-07,0.00349707698970136
174,120,128112.748046,593,346,939,188,1.37308234116063e-06,0.00474991594501279
175,119,53951.116747,475,145,620,89,7.49348600947997e-07,0.00370825247614678
176,118,46155.9667997,5,0,5,2,3.71154783351813e-07,0.00303473411834689
177,116,226055.238634,519,205,724,75,1.65037499755272e-06,0.00557025345950497
178,115,163394.692226,482,77,559,59,1.49186780618038e-06,0.0053897514453264
179,114,101111.171556,426,73,499,29,9.34586751100142e-07,0.00473164124740833
180,111,102318.506756,574,75,649,23,4.57913756690687e-06,0.0272315474560643
181,353,3148.64351745,33,4,37,11,1.38271843752591e-07,0.00172702853989567
182,352,2247.75886471,4,1,5,1,2.45842329604784e-07,0.00240822682392801
183,238,89428.8881932,234,32,266,13,3.46361048286781e-06,0.0143143713844839
184,186,16393.9926332,192,32,224,5,7.10393123881659e-07,0.00343022401381552
185,185,32491.4151676,534,10,544,12,9.8594637165661e-07,0.00397335558985785
186,184,67739.8076976,465,54,519,38,1.51700942296884e-06,0.00494672593889398
187,183,87047.7014874,424,102,526,45,3.50422624251223e-06,0.00774328330855924
188,182,40704.033168,1017,3,1020,5,9.05577962839743e-07,0.00382654259930894
189,181,108207.166913,1606,64,1670,9,2.70728241957841e-06,0.00677735175990314
190,180,32459.0695601,230,0,230,5,1.40489373734454e-06,0.00488030092548972
191,179,73818.5895279,893,1,894,11,2.7148739718541e-06,0.00665012491727902
192,178,26072.9736495,113,13,126,15,1.27111979963956e-06,0.00470219214691846
193,177,24841.5703748,6,3,9,3,1.22986557471449e-06,0.00472229729987767
194,176,16655.9801074,70,14,84,9,1.42591397889191e-06,0.00493545010430265
195,175,88800.9630198,638,94,732,136,1.42476892506238e-06,0.00493174155338383
196,174,45394.3735288,212,3,215,7,1.18837442641961e-06,0.00457360582498699
197,173,25708.8676866,165,12,177,14,1.26377381093334e-06,0.00470223885049216
198,172,27241.5543796,331,146,477,17,1.27045450426522e-06,0.0047075275904278
199,171,8289.08037897,32,7,39,4,5.75362264498835e-07,0.00380170418355204
200,170,41277.9398103,12,2,14,1,1.0018961802416e-06,0.00413105333201459
201,150,5500.62666128,27,12,39,11,1.60614035848994e-07,0.00222650949392233
202,148,140250.435703,298,1790,2088,131,1.42640556077822e-06,0.00515931120258776
203,102,800.81989961,15,8,23,3,7.68017116570263e-06,0.0116012340763113
204,91,164136.791768,1829,278,2107,172,1.1211413948331e-06,0.00558378208872015
205,90,213074.905939,2957,995,3952,311,2.10255529964343e-06,0.00633200979476867
206,89,299852.301021,6640,1765,8405,251,2.00370004677097e-06,0.00604370816150832
207,88,61817.2393005,380,593,973,165,5.16696673003025e-07,0.00396313647416313
208,87,87364.4846887,1946,237,2183,193,9.65968411037466e-07,0.00452064167819088
209,86,67317.7232256,658,309,967,52,7.4787294579437e-07,0.00418654942350025
210,85,147471.531272,2519,106,2625,90,1.29537602333585e-06,0.00484365218173793
211,83,203794.248193,9811,545,10356,58,3.85707244277e-06,0.00802692519664999
212,82,18398.800708,149,84,233,5,2.22689732254366e-06,0.00822823802018425
213,81,8468.97974775,43,0,43,3,7.01582848705584e-07,0.00412722528480548
214,80,94355.9024459,1503,777,2280,209,7.14659108780324e-07,0.00376893554018753
215,79,57433.4930255,359,256,615,8,3.7952318052703e-06,0.0114273015082384
216,78,199612.157009,4350,1017,5367,364,1.77604078999138e-06,0.00542199917385471
217,77,233333.313222,3895,1986,5881,384,1.96261635210249e-06,0.00572089583187075
218,76,94043.8613954,1690,337,2027,203,1.12202724267263e-06,0.00496997089140288
219,75,138640.213704,2971,378,3349,240,1.08909034679527e-06,0.00496532590603521
220,74,69192.8474591,1358,192,1550,167,9.39376150199678e-07,0.00499349484949191
221,73,224877.602161,3819,386,4205,53,1.56935357153998e-06,0.00549185886947763
222,72,40428.229038,226,97,323,7,8.63056357047753e-07,0.00511170442175312
223,42,106480.658682,1122,277,1399,70,7.82149982114788e-07,0.00388494058637387
224,41,140821.150116,4625,265,4890,86,9.25889253267087e-07,0.00407107128654652
225,40,194133.797428,4161,224,4385,155,1.39303074320196e-06,0.00523527421683689
226,446,22194.5870813,41,10,51,14,6.25384473096346e-07,0.00318255320153658
227,445,18003.9778306,12,34,46,17,1.00181614470785e-06,0.00426152690453671
228,444,5351.18707292,111,30,141,3,5.26269559486536e-07,0.00336121557673678
229,443,10364.6638369,3,2,5,1,7.92233549873345e-07,0.00350324390015501
230,442,27552.6571204,147,34,181,8,2.19908270082669e-06,0.00664130749543387
231,441,7712.15900199,24,10,34,9,3.94522885471815e-07,0.00267317554505566
232,440,57982.1426179,105,14,119,15,1.29142017613049e-06,0.00586877909459892
233,439,13502.0962831,33,30,63,16,3.88358330383198e-07,0.00254555648342633
234,438,64195.5305546,23,7,30,10,3.21440529660322e-06,0.00775066383568565
235,437,16346.8434205,45,9,54,5,4.70923168904847e-07,0.00296607028237654
236,436,19288.6366214,14,17,31,7,8.57691247801995e-07,0.00371463815641157
237,435,6589.21453014,3,2,5,1,2.93474840873387e-07,0.00243683157701065
238,434,24373.8155023,297,2,299,21,2.81892425846308e-06,0.00683774264488304
239,433,17030.4504667,59,47,106,3,1.38076029543299e-06,0.0070350193952842
240,432,7813.73930001,12,4,16,9,2.20849869947415e-07,0.00228889703649992
241,431,8470.38762807,36,30,66,16,4.81018560094526e-07,0.00283343935096569
242,430,27465.9722792,71,33,104,19,1.11404960989603e-06,0.00588843158682827
243,429,65322.5852126,23,15,38,5,7.70713540987344e-07,0.00515603611834789
244,428,11077.0795538,111,34,145,25,3.60344529326539e-07,0.00339277452286145
245,427,18215.9960879,10,13,23,5,1.28755209516385e-06,0.00516036353069407
246,424,32390.6718876,288,23,311,12,1.70177690961282e-06,0.00961354998637971
247,400,14407.5047925,3,1,4,2,1.02669991974835e-06,0.00724085440084867
248,423,24947.3753512,296,82,378,6,8.26729319669539e-07,0.00370973997351941
249,422,139945.830846,1244,452,1696,3,2.5728227228683e-06,0.00789243415962986
250,421,4506.72128137,46,16,62,2,3.6328401620267e-07,0.00278834690419579
251,411,42971.9328906,46,34,80,6,5.70433985558338e-06,0.0103288466811746
252,410,17480.2357445,3,2,5,1,5.72058524994645e-07,0.0029937293650144
253,408,91273.0074808,26,1,27,11,3.20207846016274e-06,0.00833743967943742
254,407,133234.602266,493,231,724,20,4.01001398131484e-06,0.0105803583354279
255,406,34577.6668981,28,13,41,11,1.130525561166e-06,0.00466252949788677
256,405,12190.0489818,21,13,34,8,2.95282916340511e-07,0.0026414197801052
257,404,23819.9311845,68,120,188,22,6.23403593635885e-07,0.00314624052320907
258,403,26405.8367443,164,131,295,56,9.41190592129715e-07,0.00535648789462463
259,402,19321.414165,67,131,198,13,6.32486717222491e-07,0.00341289978218271
260,401,106140.669207,59,38,97,13,1.40315069074859e-06,0.00541025139843202
261,357,40647.1980283,537,20,557,34,3.77864580514142e-07,0.00247700386713609
262,356,27779.2489647,3,0,3,1,3.91076355299447e-07,0.00248046953293301
263,355,7676.98743079,16,10,26,6,3.1593026506016e-07,0.00231314687667817
264,354,47665.5148585,156,23,179,13,1.27695375340409e-06,0.00503340507443726
265,351,26639.9882334,51,7,58,10,1.24790722111356e-06,0.00519715889475913
266,350,75585.3568353,1198,129,1327,96,1.1851348062919e-06,0.00478191984910479
267,349,12864.8920235,42,14,56,3,1.15051625471096e-06,0.00480027559414226
268,345,810.17919097,26,10,36,1,2.46828676608857e-07,0.00206915069978388
269,344,4640.36357604,2,5,7,1,2.02669070858974e-07,0.00214101806249325
270,340,10055.2322928,26,27,53,8,1.19633068607072e-06,0.00443944551878706
271,339,46407.5875746,588,54,642,43,1.58391867444152e-06,0.00528941847453204
272,338,31215.0593561,415,66,481,5,1.74566866917303e-06,0.00548015491233723
273,337,27600.9492177,51,33,84,3,2.71252247330267e-06,0.00750751123710405
274,336,7687.40023821,57,47,104,7,5.06399828736903e-07,0.00302332354049801
275,333,11317.3624827,13,15,28,2,2.39912878896575e-07,0.00228768689914856
276,332,25074.4568708,9,3,12,4,1.05526351035223e-06,0.00564503418770949
277,420,6674.44033589,71,11,82,13,7.22922777640633e-07,0.00368211549391952
278,419,8545.449,7,1,8,2,7.05057118466357e-07,0.00343816047262971
279,331,9291.2619093,17,29,46,5,7.64957803767174e-07,0.00563983394757403
280,329,14909.5328395,69,14,83,17,7.88438683230197e-07,0.00495345329409297
281,327,10119.4743796,11,8,19,5,1.59199316840386e-07,0.00174424469155262
282,326,43667.7332071,72,62,134,19,1.53106111611123e-06,0.00659627918616791
283,325,76093.8789822,46,3,49,6,1.70773546415148e-06,0.00722633916685968
284,324,36156.4344387,156,116,272,39,5.52473011339316e-07,0.00474926352225185
285,323,21254.9758296,65,62,127,23,7.25796326150885e-07,0.00481963106782358
286,322,21397.8338861,11,5,16,4,4.85509644931881e-07,0.00343071789437183
287,321,9074.22676099,11,16,27,5,3.12461907014949e-07,0.00226437510231525
288,320,38967.2112434,116,65,181,40,8.08303866506321e-07,0.005095229293044
289,319,4430.15385712,6,4,10,1,1.8871878637583e-07,0.00174860562664753
290,318,14968.0827852,17,16,33,6,5.42855104868067e-07,0.00322802505677308
291,317,7761.92874034,31,12,43,12,1.48497292684624e-07,0.00155241095040443
292,316,18025.2745998,56,64,120,21,5.72063527215505e-07,0.00305530478750935
293,315,131917.779754,231,58,289,34,3.92993069908698e-06,0.00929190247336219
294,314,20791.2785518,27,28,55,5,6.89900844008662e-07,0.00517408460548986
295,237,43736.6867733,1,0,1,1,1.3690946616407e-06,0.0052752708841415
296,236,40477.0930598,0,0,0,1,1.33774574351264e-06,0.00472735578154733
297,234,89595.1650754,678,45,723,8,5.80665755478549e-06,0.0130759803609037
298,233,57685.6169428,787,110,897,94,2.31820513363346e-06,0.00795954554198209
299,232,54788.4151216,2,0,2,1,2.12211216421565e-06,0.00679771318366769
300,231,15942.8243287,2,3,5,2,1.24780353871756e-06,0.00500665123700766
301,230,33189.9833338,21,7,28,6,2.0119450709899e-06,0.00589885528137776
302,229,16525.683978,103,24,127,13,1.61234720508219e-06,0.00599901790544492
303,228,102617.884184,7,2,9,3,2.21709979086882e-06,0.00650560284004473
304,226,190206.416,1086,90,1176,15,6.81613755659782e-06,0.0113699737494189
305,225,12911.6779919,81,12,93,2,2.16302532862755e-06,0.0100049290315931
306,223,22696.0121879,272,90,362,32,4.52725498689688e-06,0.012725316076824
307,218,13576.1050354,82,0,82,2,9.4386587079498e-07,0.00488285422056031
308,220,8090.96781689,34,22,56,10,4.65904122393113e-07,0.00417775633245288
309,217,18168.6064809,343,30,373,24,1.17647505248897e-06,0.00476052452819184
310,216,63933.7558323,442,12,454,40,1.84188183993683e-06,0.00641718498760631
311,215,230452.430514,1083,1350,2433,15,3.72435215467704e-06,0.00810492869463419
312,214,10393.1473639,34,21,55,8,3.41493432642892e-07,0.00255394788357327
313,213,6485.86028757,95,3,98,7,2.53359758062288e-07,0.0023948682681821
314,212,83474.2536701,1491,278,1769,21,1.55122597789159e-06,0.00500916185272829
315,211,31182.7603479,28,17,45,12,5.46004230272956e-07,0.0031532033444805
316,210,43461.6595211,304,78,382,19,7.13028839527396e-07,0.00349876725346927
317,209,54359.8645462,70,1,71,4,9.7854399427888e-07,0.00453555887213015
318,208,6007.28722643,116,7,123,7,2.32335878536105e-07,0.00232563720445214
319,207,75301.6701565,18,21,39,9,1.58656439452898e-06,0.00553680756607473
320,206,113138.344946,510,29,539,22,1.23371319205035e-06,0.00466753595178134
321,205,15479.4026506,26,15,41,14,5.94734046899248e-07,0.00381882686160986
322,204,71008.9943075,47,31,78,15,7.72253770264797e-07,0.00470966722020721
323,203,58671.5083137,351,56,407,7,6.77735897625098e-07,0.00428928010899359
324,200,10484.7946613,21,5,26,4,3.84601662517525e-07,0.00282307442825902
325,823,13278.017722,28,28,56,7,3.61185357178329e-07,0.00281616646448798
326,822,9831.66193867,18,0,18,2,8.42254848976154e-07,0.00391837899383687
327,821,31105.9751521,135,28,163,17,1.48180697578937e-06,0.00596293023440969
328,820,13792.5294076,61,8,69,4,8.16247393231606e-07,0.00370436712867227
329,819,9347.17626483,126,24,150,13,6.29230726190144e-07,0.00328846121979317
330,818,3042.83128365,4,0,4,1,2.82512246485567e-07,0.00276080323647037
331,817,8293.92115965,7,0,7,1,5.577230695053e-07,0.00306787348170607
332,816,2054.04082026,52,16,68,4,1.86457782547222e-07,0.00221259859360332
333,815,10829.0639189,15,2,17,2,4.38881215814035e-07,0.0031644731511508
334,814,18584.1486611,49,2,51,6,7.35880348656792e-07,0.00362927470156317
335,813,8774.21737484,12,3,15,2,4.44542365585221e-07,0.00272843464658359
336,811,8751.65479221,136,44,180,29,4.6245031626313e-07,0.00311332965644224
337,810,10506.6678451,122,27,149,10,1.15672582978732e-06,0.00432084100874896
338,809,10364.1271463,19,4,23,5,4.28219664172502e-07,0.00303945852813072
339,808,56342.2660535,7,5,12,1,1.98753741642577e-06,0.00594253385103479
340,797,10122.401568,36,0,36,2,6.18173999100691e-07,0.00354235358111577
341,796,6228.5814663,33,2,35,6,3.93658865505131e-07,0.00304604409621546
342,795,7833.00452298,77,9,86,7,3.20900653605349e-07,0.00277265275857739
343,794,11667.5638134,91,12,103,16,4.61623130831867e-07,0.00287186529830281
344,793,4756.8830372,24,11,35,7,3.56722466676729e-07,0.00247385036309487
345,792,5383.70396868,22,2,24,7,3.29849626723444e-07,0.00231627704689302
346,791,15506.5988773,69,14,83,15,6.25916982244235e-07,0.00331390376511133
347,790,8579.89913074,4,4,8,3,2.99241946777329e-07,0.00327486251636522
348,789,13661.7576567,121,68,189,17,8.1695725384634e-07,0.0036543484909177
349,788,20852.7703936,53,1,54,14,8.28484644443961e-07,0.0040806610416721
350,787,13571.8271203,62,4,66,12,6.174350346555e-07,0.00407453058032761
351,786,68928.8918233,27,0,27,3,3.30638340528822e-06,0.00723628411617204
352,785,13586.5847913,61,8,69,5,2.07377979677403e-07,0.00195103620263448
353,784,13812.2720016,1,0,1,1,5.21063157066237e-07,0.00374137528577172
354,783,22705.5653263,229,33,262,3,3.36683569912566e-07,0.00261981977235298
355,782,2564.08758196,17,7,24,3,1.01956175058149e-07,0.00155644122456686
356,781,68085.6184575,2123,19,2142,25,1.61792604558286e-06,0.00568204326685888
357,780,18740.71525,78,7,85,14,2.93674474960426e-07,0.00273629606482252
358,779,38683.2305278,92,19,111,14,3.2490743251401e-07,0.00282967735265193
359,778,91245.7275703,734,122,856,25,1.83207744157698e-05,0.0231476442123781
360,669,13883.589712,44,6,50,5,6.1847140386817e-07,0.00389746145700284
361,646,14875.6216759,24,4,28,3,2.88505680146045e-06,0.00867227585724189
362,627,15759.2550584,13,28,41,4,1.04065065897885e-06,0.00714480707626837
363,757,15555.3893506,3,1,4,2,1.03431739262305e-06,0.00717349678723288
364,609,9330.00570078,48,5,53,8,1.71419287653407e-07,0.00231863296665455
365,610,19874.0313202,345,150,495,10,2.88071987597505e-07,0.00362864625533176
366,608,11868.7849992,94,0,94,10,8.07964124760474e-06,0.0134931758236279
367,308,112739.630471,807,1,808,14,2.39880760091182e-05,0.0349416321661543
368,307,90791.6683601,1230,11,1241,18,2.54550286626909e-06,0.00805928519512297
369,306,46825.8036504,13,0,13,5,1.28577494251658e-06,0.00500293507922072
370,305,94923.6225405,33,13,46,6,2.83761710306862e-06,0.00836935875436205
371,304,51874.89882,2,6,8,1,1.93001415027538e-06,0.00730842375395723
372,303,31586.2622716,51,32,83,13,7.98199380369624e-07,0.00400826260618398
373,932,9478.41609909,9,0,9,2,7.37717982701724e-07,0.00395607227254589
374,931,4005.72740716,31,0,31,2,5.96963673160644e-07,0.00327634622770689
375,861,5281.97699333,48,20,68,18,5.01701833854895e-07,0.00298724902370416
376,860,21236.7583071,89,41,130,18,1.35850996230147e-06,0.00607776208694901
377,844,64197.3379075,311,23,334,13,4.2464539546927e-06,0.00927916262880687
378,843,15466.8903769,10,0,10,1,5.01820068166126e-07,0.00404953594811229
379,841,11206.4990775,13,5,18,5,7.89274054113775e-07,0.00418509345135709
380,840,14931.7720954,17,8,25,6,4.99867383041419e-07,0.003790588676858
381,839,26061.8956874,59,39,98,19,7.64399374020286e-07,0.00377754509742157
382,838,13805.3162926,29,34,63,10,8.10979599918937e-07,0.00389489314243786
383,837,24583.2147088,41,3,44,4,5.85757334192749e-07,0.00403642066706716
384,836,18013.6772061,22,22,44,2,8.15057774161687e-07,0.0046859989349841
385,835,15124.734972,51,18,69,10,9.13059921003878e-07,0.00506043721276762
386,833,32036.5406245,314,9,323,11,1.41203145176405e-06,0.00624149966562618
387,832,28529.2091466,249,38,287,6,9.54825736698695e-07,0.00438423010071018
388,830,108020.555664,490,5,495,10,7.84983149060281e-06,0.0113835111237547
389,829,32308.6704414,31,0,31,13,1.93219830180169e-06,0.00717973556018041
390,828,18928.0657204,29,1,30,7,5.80777395953191e-07,0.00341018656501848
391,827,34642.538226,225,155,380,11,2.81910433841404e-06,0.00875594372461733
392,826,9658.49470058,49,15,64,9,7.62071977078449e-07,0.00393543060840529
393,807,7968.061448,3,3,6,2,3.42616203852231e-07,0.00245265961315744
394,806,9730.32360592,17,4,21,2,5.11853158968734e-07,0.0030055774074683
395,802,4076.81817209,76,14,90,2,2.30907971854322e-07,0.00193515627871271
396,801,11708.1846727,63,0,63,4,4.11102519137785e-07,0.00305328578449082
397,800,18267.5209922,5,1,6,3,6.55266831017798e-07,0.0034377105555035
398,565,27129.3065655,229,9,238,67,3.92375568480929e-07,0.00260734667733052
399,564,58120.1565887,1146,110,1256,134,8.96621259016683e-07,0.00395495271021807
400,563,5112.069605,52,83,135,15,2.72989382210653e-07,0.00259395238114504
401,562,9014.84968304,136,481,617,8,2.14235569728771e-07,0.00205835379164382
402,561,23067.5428332,95,43,138,37,4.1219800550607e-07,0.00340644457591034
403,560,6749.58783953,116,23,139,15,1.89046659215819e-07,0.00178302810773325
404,968,31842.8998465,39,16,55,4,1.14784756988229e-05,0.014492367256987
405,967,29000.5944594,0,0,0,1,3.48799585481174e-06,0.0081888727798409
406,965,3713.38205119,20,0,20,2,2.20845777221257e-07,0.00203741892087718
407,961,7057.8895766,3,16,19,1,4.73866748507135e-07,0.00320294099756935
408,959,32360.150962,29,20,49,3,3.02187663692166e-06,0.00778251198042208
409,958,26435.4775286,20,18,38,9,2.57396050074021e-06,0.00646852275079713
410,953,14773.183903,7,3,10,2,1.88365447684191e-06,0.00623736703491243
411,952,27546.4386393,80,74,154,14,2.16250100493198e-06,0.00604640540840787
412,951,28157.147729,25,27,52,16,1.73759462995804e-06,0.00538084920650314
413,949,15875.5711364,11,3,14,3,2.46452191277058e-06,0.00680959104982501
414,948,11618.1734372,88,87,175,21,7.17509919923032e-07,0.0035760254589758
415,947,9341.40900866,57,2,59,3,6.53741608402925e-07,0.00346672429507352
416,941,8616.57076585,2,6,8,2,6.94676145940321e-07,0.00353003939493975
417,940,9814.27049044,1,2,3,1,7.22930963092949e-07,0.00357134046773179
418,939,9423.99961584,2,0,2,1,9.83557583822403e-07,0.00433608300856009
419,938,3695.92824988,4,3,7,2,2.73991645372007e-07,0.00210735425096197
420,937,8666.69202371,39,53,92,11,1.0033804755949e-06,0.00473035974877693
421,935,10570.1187507,0,1,1,1,6.41187853034353e-07,0.00334772454183574
422,927,8703.84740199,2,0,2,1,1.01260275187087e-06,0.00443019258345436
423,926,9762.30200188,12,0,12,1,1.05452636489645e-06,0.0048330450741469
424,925,20779.768637,48,67,115,26,1.25133237816044e-06,0.00538669091848895
425,924,18423.1322769,37,14,51,12,1.73788157553645e-06,0.00620313661319102
426,921,10645.4332129,4,4,8,1,1.01399746199604e-06,0.00540031052400685
427,920,14404.2975311,14,46,60,8,1.17338004201883e-06,0.00475249390431095
428,919,9192.91513774,14,13,27,6,8.44373062136583e-07,0.00389753055216121
429,918,12078.5575073,3,0,3,1,1.34793936013011e-06,0.00494274415893053
430,917,36580.3560174,139,37,176,10,1.52262600749964e-06,0.00762729202886824
431,916,17866.1405937,228,34,262,5,1.16599585453514e-06,0.00551435603522185
432,915,19447.7238107,87,11,98,2,2.03822219191352e-06,0.0112609865608784
433,913,31144.9699351,117,50,167,29,2.59310127148638e-06,0.0083801049504324
434,912,6498.3126266,13,74,87,6,9.73287569649983e-07,0.00410406202652137
435,911,10480.7401227,31,148,179,20,1.18529851533822e-06,0.00470063546149651
436,472,15184.7986378,40,33,73,19,5.57521161681507e-07,0.0041951229748577
437,474,21675.80209,74,46,120,19,1.54851659317501e-06,0.00550831219419225
438,491,13491.3873817,10,13,23,5,4.83634721604176e-07,0.00283752173642701
439,492,24686.9669735,50,11,61,9,5.9974172472721e-07,0.00309405205694952
440,494,15562.0865753,69,16,85,6,5.80240794079145e-07,0.00316220097770741
441,495,7304.6110007,87,14,101,6,4.51530013378942e-07,0.00267406336250786
442,496,19469.4731563,191,10,201,15,1.07978212326998e-06,0.00447529316425364
443,497,34472.9664359,98,9,107,14,1.62324431585148e-06,0.00579796087355601
444,498,17211.0364382,101,34,135,14,1.59763476403896e-06,0.00517397116975902
445,499,19982.632272,38,30,68,11,1.24581129057333e-06,0.00446019507550881
446,500,10669.9979316,12,9,21,3,6.7224254962639e-07,0.00374901173966175
447,502,17681.4966878,131,100,231,7,8.26658833830152e-07,0.00362488256659376
448,503,20092.90116,13,3,16,6,1.33156299852999e-06,0.00476002928246296
449,505,7801.3678886,13,5,18,2,4.68507096229587e-07,0.00330910581227923
450,507,21160.772522,107,25,132,11,9.45323790801922e-07,0.00487700034198372
451,508,21013.0063085,35,1,36,7,9.23720563150709e-07,0.00404106440562792
452,509,8101.96844051,54,9,63,17,7.06033006281359e-07,0.00365924312115551
453,510,18916.505205,38,1,39,9,1.43125544127543e-06,0.00493812143795165
454,511,5315.12019892,21,37,58,8,4.2010287870653e-07,0.00318767068558926
455,512,27977.5588872,57,12,69,9,6.04877186560771e-07,0.00330087655335553
456,513,12651.1811544,33,21,54,4,7.87241788202664e-07,0.00359636441040698
457,514,22599.7879157,178,69,247,35,8.35316313896328e-07,0.00371139043958385
458,515,18012.3960853,13,59,72,11,8.33874310046667e-07,0.00516262745740642
459,516,16319.3171731,120,33,153,17,8.00242105469806e-07,0.00402456587430027
460,517,21072.4635063,268,82,350,33,8.46240254759323e-07,0.00411539896057818
461,518,31103.3460669,525,208,733,60,8.71475549502065e-07,0.00420644085891834
462,524,70190.0465482,664,407,1071,148,1.49209881783463e-06,0.00629573967945109
463,525,11106.0507208,57,37,94,19,5.28385498910211e-07,0.00327269236382754
464,526,10820.4730886,28,23,51,15,9.99250914901495e-07,0.00402536691277193
465,527,2923.60415676,47,0,47,1,5.38768290425651e-07,0.00299410595666386
466,528,10969.1825762,75,7,82,33,8.60219643072924e-07,0.00447633966043561
467,529,14901.3384528,213,22,235,21,4.94883352075703e-07,0.002803625641189
468,530,45402.3781713,171,46,217,24,1.53162318383693e-06,0.00502647221512692
469,531,8924.94030542,46,5,51,12,8.06583102530567e-07,0.00369517344044126
470,532,8622.89545725,48,13,61,8,4.79321897728369e-07,0.00281375297984592
471,533,3129.03203584,1,1,2,1,2.551355464675e-07,0.00229763335458317
472,534,14108.9170328,15,7,22,5,1.07022333395435e-06,0.00487223677980354
473,537,13555.4101643,89,25,114,8,1.09175425677677e-06,0.00470588205107689
474,538,9273.68034999,4,3,7,2,8.8250726548722e-07,0.00510465945425237
475,540,22313.2220629,11,15,26,1,2.01141119759995e-06,0.00596317422666685
476,541,4580.7010542,19,5,24,7,7.0197575041675e-07,0.00469721272746091
477,984,14841.3543896,11,8,19,3,1.05468870970071e-06,0.00469772257948264
478,982,36787.1375756,21,5,26,7,3.07438494928647e-06,0.00711691533409803
479,493,16660.8898413,66,17,83,21,1.05062554212054e-06,0.00421457376527691
480,399,4661.67396487,3,0,3,1,3.41764916811371e-07,0.00318395099549384
481,417,22469.0432681,22,2,24,6,2.04681737159262e-06,0.0105936668577641
482,416,48133.7124394,119,14,133,42,1.54612962433021e-06,0.00654747352700703
483,415,25968.1790934,126,3,129,7,1.45527519634925e-06,0.00563469223459837
484,542,13264.6952782,7,2,9,3,9.4393772087642e-07,0.00498393471424304
485,543,11109.8298955,30,0,30,6,9.66478182817809e-07,0.00505922105531387
486,544,20131.5999368,23,31,54,10,1.38134782901034e-06,0.00556520280399081
487,545,26418.2215466,91,42,133,45,1.67288544616895e-06,0.00625378382617746
488,546,16423.6160708,29,17,46,12,1.37969982461073e-06,0.00497145082034334
489,547,14975.3542652,9,2,11,2,7.25063273421256e-07,0.00433262998380405
490,548,9256.40206396,12,14,26,4,6.12526037002681e-07,0.004156689169931
491,549,4278.69239884,0,0,0,1,3.91496996599017e-07,0.00301851488804768
492,550,9450.7636057,39,49,88,19,1.0897206266236e-06,0.00420486938339627
493,551,5345.84271263,42,15,57,11,3.33696789311944e-07,0.00285748236251615
494,552,4674.83530061,0,0,0,4,6.44135070615448e-07,0.00338996004534637
495,554,6619.72494817,35,14,49,9,4.62639491161099e-07,0.00272377392874006
496,555,15493.2602259,71,15,86,15,7.65043751016492e-07,0.00365079995346391
497,556,23383.0160368,45,7,52,4,7.55379460315453e-07,0.00430828877608513
498,566,4107.63239161,20,18,38,8,2.64253230852773e-07,0.0024458464757235
499,568,4422.43339287,78,4,82,15,1.40505107992794e-07,0.00152892740982206
500,569,18178.6002008,193,4,197,13,4.19561274611624e-07,0.00263067665134857
501,570,22806.3694505,304,46,350,63,5.5620466810069e-07,0.00300028155613189
502,571,8153.2809083,45,1,46,13,4.58836439065635e-07,0.00276422745660846
503,572,23632.1132524,156,0,156,5,6.52094968245365e-07,0.0032543584370715
504,574,15362.8376366,91,17,108,13,6.09524249739479e-07,0.00337195864279784
505,573,22557.2164877,47,3,50,15,6.39804511592956e-07,0.00317863268739361
506,575,20899.8663662,119,7,126,18,6.79631284583593e-07,0.00332304723713902
507,576,7079.93142938,14,5,19,4,2.51930032391101e-07,0.00224310156203454
508,577,12404.3365983,135,30,165,3,6.28573161520762e-07,0.00317455016036414
509,578,25169.1134158,8,11,19,1,8.59461579238996e-07,0.00414971974950215
510,579,8339.42955732,42,44,86,14,6.34901425655698e-07,0.00338350289913592
511,581,5473.36994674,2,2,4,1,4.99018369737314e-07,0.00291311351006771
512,582,26456.0290767,242,13,255,52,6.68541815684875e-07,0.0034796066435183
513,583,3894.96946325,1,0,1,1,3.36715402227128e-07,0.0023268138433422
514,585,5496.89895804,4,0,4,3,5.61874912818894e-07,0.00315495259290422
515,586,20847.4832464,95,40,135,26,1.05019807961071e-06,0.004330049478765
516,589,18684.0124939,19,10,29,4,1.63399135999498e-06,0.00593694549239836
517,590,129603.50856,26,19,45,7,4.65528592030751e-06,0.00848360918265645
518,591,8557.62708122,5,3,8,1,6.67268977849744e-07,0.00346034128891489
519,594,6683.30576992,7,6,13,2,5.90058334637433e-07,0.00316212273775352
520,596,27606.1504624,188,86,274,30,2.82474366031238e-06,0.00672868382991364
521,597,8591.23645951,132,159,291,26,1.35640175358276e-06,0.00508470194181427
522,598,5766.36860603,4,0,4,1,5.79250809096266e-07,0.00306002493835436
523,600,5913.14208573,2,1,3,1,7.71258328313706e-07,0.00359651442228667
524,602,5903.18380214,11,19,30,2,8.54352492751786e-07,0.00370781732289784
525,558,35939.0877477,890,6,896,1,5.82026586926077e-07,0.00314185119737451
526,490,12170.1182369,157,14,171,18,2.69990778178908e-07,0.00235234325826851
527,605,10130.3238992,2,3,5,3,1.05919934867416e-06,0.00419021539742907
528,611,6471.63108149,16,3,19,7,4.1260818761657e-07,0.00349053878793802
529,617,7831.9169066,1,0,1,2,9.93712092167698e-07,0.00415491400623016
530,618,5494.53942735,1,1,2,1,5.87557224207558e-07,0.00303037710104952
531,619,4870.6827725,17,17,34,4,2.82542259810725e-07,0.00267452623493324
532,623,3670.41442481,1,9,10,1,1.05303251984878e-06,0.00417489298464637
533,624,13532.1263834,19,5,24,9,1.45245076055289e-06,0.00531879895257395
534,626,41613.5370134,123,24,147,43,2.26969450523029e-06,0.00780706236989881
535,628,80954.3550654,1140,122,1262,6,3.34818696501316e-06,0.00772908002569964
536,629,12383.609376,37,23,60,11,7.18813225830672e-07,0.00368254216919189
537,630,10372.4995954,25,7,32,7,7.18264345778152e-07,0.00371398103814714
538,632,17704.319352,37,11,48,5,1.48414346767822e-06,0.00584272418814356
539,633,9226.21346825,8,0,8,1,9.16080807655817e-07,0.00384357717175847
540,634,59502.553323,15,1,16,4,1.91950448424905e-06,0.00561546641214188
541,636,32050.5054993,54,91,145,2,2.17611113839666e-06,0.00586348312093159
542,637,21949.5688681,4,0,4,1,1.05713615994318e-06,0.00445320724786282
543,638,17712.3677149,77,42,119,10,8.41816017782548e-07,0.00415707772877939
544,639,19190.5863098,119,16,135,14,8.45470822241623e-07,0.00413839601236735
545,640,14850.5414962,80,0,80,7,1.46724914884544e-06,0.00545820667189181
546,641,21843.7467508,39,2,41,6,1.46153342939215e-06,0.00545275782567777
547,642,16539.1151775,39,4,43,7,8.41169821796939e-07,0.00416085403930378
548,643,10499.2184587,10,0,10,4,4.14333499065833e-07,0.00263757961658324
549,644,25550.1270881,145,10,155,13,1.1608944987529e-06,0.0050302021057686
550,645,33936.0349248,14,3,17,1,9.75482180365361e-07,0.0047149325926316
551,647,9939.60249312,70,6,76,26,7.5591651693685e-07,0.00380020491535029
552,648,28299.9456861,570,29,599,23,8.46177499624901e-07,0.00379279737857786
553,649,15484.0502749,109,16,125,28,7.63548541726777e-07,0.00387062426409455
554,650,16348.9819745,45,8,53,3,1.36666676553432e-06,0.00567627242083369
555,651,7397.4722666,50,8,58,7,1.62804144565598e-06,0.0065921275089037
556,652,41838.7921577,157,78,235,42,1.86865645446233e-06,0.00839483070838885
557,656,21813.8002903,125,13,138,26,1.3335702533368e-06,0.00526371819152778
558,657,13854.0515637,52,35,87,11,7.50620529288426e-07,0.00344286377974701
559,658,1012.00242654,7,0,7,2,3.30263901560102e-07,0.00233174591742635
560,659,24314.8314557,4,8,12,5,1.16195769805927e-06,0.00502017544728967
561,660,11274.617246,60,8,68,8,5.92473952565342e-07,0.0033385194961752
562,661,21737.4235807,21,4,25,9,7.96756467025261e-07,0.00372493839067019
563,662,7974.52947495,34,6,40,5,5.73465058550937e-07,0.00308062884855695
564,489,16616.3806974,222,45,267,45,3.44305135513423e-07,0.00270436772650999
565,488,4431.53171519,11,9,20,6,1.36710696096998e-07,0.00161454012913867
566,487,6345.22398248,55,26,81,8,2.15254658542108e-07,0.00193741652188625
567,666,3636.18278111,18,0,18,1,2.17475644603837e-07,0.00255034121853711
568,667,14903.8439369,24,2,26,4,9.16756562219234e-07,0.00527746125687274
569,670,5176.42581129,16,1,17,2,3.67862412531395e-07,0.00335828046473666
570,672,4365.64024408,15,0,15,1,4.74255557492143e-07,0.0037596103347823
571,673,6088.82798041,8,3,11,1,7.21021478966577e-07,0.00451748396243391
572,674,8699.81600935,6,10,16,1,8.34420006867731e-07,0.00516825320532065
573,678,5541.63144931,23,0,23,1,4.88025762024336e-07,0.00310942594984486
574,679,11348.4443434,5,2,7,2,6.98611529514892e-07,0.00462292356352528
575,680,740.72528515,1,0,1,1,1.58782313519623e-07,0.00200661143750965
576,683,6120.10050372,19,2,21,3,4.74395164928865e-07,0.00425586145093127
577,684,13674.4969921,19,5,24,9,1.0750477485999e-06,0.00483254066606683
578,685,5079.1135371,41,0,41,1,3.13245891447878e-07,0.00298739745011366
579,686,14241.0895027,9,1,10,5,1.30857279145857e-06,0.005526064123128
580,688,35367.5879279,427,148,575,14,3.51773724105442e-06,0.00785110349142225
581,689,21517.368893,2,2,4,1,1.56679288920714e-06,0.00566945651479544
582,849,5417.74778392,34,21,55,13,4.14487658417784e-07,0.00264223200944613
583,850,3070.10037281,29,11,40,10,1.96576820599148e-07,0.00182931664232504
584,851,3156.92588712,7,2,9,1,2.66557435679715e-07,0.00206470681997716
585,856,3356.21378579,4,0,4,2,2.96018242806895e-07,0.00215550689064096
586,857,6198.39132941,34,10,44,14,3.68525434168987e-07,0.00246419322326893
587,858,8783.75497734,76,54,130,16,9.0032335720025e-07,0.00385277165785739
588,859,6456.80862933,3,0,3,1,5.78666004003026e-07,0.00353371589029172
589,690,11363.4333859,25,18,43,10,1.01775822258787e-06,0.00520137932711758
590,691,42215.9893302,58,46,104,12,2.6048351173813e-06,0.00788347441480064
591,692,7579.00654466,2,0,2,2,6.3906281866366e-07,0.00322402096305576
592,696,10407.2928852,5,2,7,1,1.05004119177465e-06,0.00444773927518335
593,695,18934.1107105,54,30,84,19,6.76509898767108e-07,0.00360232072401347
594,697,15963.8046218,71,71,142,20,1.25278029372566e-06,0.00544803785978841
595,698,18002.1351619,54,75,129,22,1.25272936202236e-06,0.00478869041440214
596,699,23160.2236406,115,58,173,40,1.67142434293055e-06,0.00647542879799118
597,700,5778.79309714,42,41,83,17,1.94750555237988e-07,0.00209145921920489
598,702,5833.09462745,2,2,4,1,4.96033408126095e-07,0.00283513033128709
599,486,3320.18650068,30,3,33,1,1.06902916741092e-07,0.00149884959646351
600,484,20932.1011029,496,78,574,35,4.44549641542835e-07,0.00302484202956382
601,483,9204.29256874,95,20,115,5,1.60835952556226e-07,0.00194475837133936
602,482,4881.4634507,93,5,98,7,1.82828443939798e-07,0.00179645824412812
603,414,55365.1531225,54,15,69,12,2.26037855100003e-06,0.00769004422589497
604,706,9594.46683086,50,11,61,5,1.25634460346191e-06,0.00459949572066298
605,707,15646.2802823,7,0,7,1,1.2361783774395e-06,0.00453277569088828
606,708,14462.2902202,2,3,5,1,1.52089387484011e-06,0.0058712193259788
607,712,3287.79338808,0,1,1,1,4.04165803047363e-07,0.0031714827956688
608,713,11417.1356862,4,9,13,2,1.43075976666296e-06,0.00580433526515288
609,714,5829.03613406,1,0,1,3,6.38871370028937e-07,0.00460249092759819
610,715,8709.3327932,15,19,34,5,1.05402750705252e-06,0.00449286709048971
611,716,7440.94780815,2,9,11,1,1.16545834316639e-06,0.00473215323563466
612,720,1804.59717802,7,0,7,2,3.45677108271047e-07,0.00231087538030432
613,721,29751.9764682,161,25,186,34,4.72784267913084e-06,0.0104161511813034
614,728,14674.6762085,0,2,2,2,1.85286444320809e-06,0.00666269698249728
615,729,10293.3344428,12,6,18,7,5.17882199346786e-07,0.00552429778492775
616,730,6849.26120743,33,8,41,12,6.84536189510254e-07,0.003348507271489
617,732,8897.30522977,11,5,16,5,6.40933194517856e-07,0.00568347212494208
618,737,10317.68576,1,2,3,1,1.34671108753537e-06,0.00533928670286603
619,739,4205.01243129,33,38,71,11,3.58373199560447e-07,0.00285762797155213
620,740,14517.5359219,24,20,44,9,7.56447207095334e-07,0.00430285852236762
621,741,10058.4556665,25,0,25,5,6.05294189881533e-07,0.00323518744146404
622,746,9495.55497212,4,2,6,2,9.6277472039219e-07,0.00413522041986078
623,747,12221.6722375,11,4,15,6,1.14472686618683e-06,0.00581541261691168
624,751,4416.82356814,1,0,1,1,6.27923327556346e-07,0.00337778834938765
625,752,13334.3014334,14,21,35,5,1.63492995852721e-06,0.00520709261132571
626,753,20925.5016478,8,12,20,4,1.60171794050257e-06,0.00561005562872357
627,754,23265.0071565,1,2,3,1,2.03827084988006e-06,0.00608376092817736
628,1000,25716.7637617,5,2,7,3,2.3041225176712e-06,0.00709895716201802
629,1001,98158.1642968,21,16,37,9,3.76881962438347e-06,0.00838840994522437
630,1002,22932.5091834,38,25,63,11,2.20561469177483e-06,0.00635003963037667
631,1003,137646.317056,507,6,513,41,1.44720193020476e-05,0.0174042495326228
632,1004,9424.56032861,30,10,40,1,1.51347603605245e-06,0.00565245359960318
633,1005,15135.3447944,1,0,1,1,1.50664800457889e-06,0.00564273489357382
634,481,16685.59915,6,2,8,4,2.39226210396737e-07,0.00200187636384103
635,480,41176.5063384,681,4,685,3,2.35718789554085e-06,0.00670730495046202
636,479,6935.7399896,0,0,0,1,7.80922164267395e-07,0.00350768439879683
637,477,33189.2986722,87,34,121,28,1.56296209752327e-06,0.00515515142472424
638,478,75663.7736632,126,63,189,20,2.40316967392573e-06,0.00629485750692584
639,485,8352.15589598,75,3,78,14,3.22842424793635e-07,0.00243035681444911
640,476,10055.9173653,27,9,36,3,5.20545654580928e-07,0.00387913457585056
641,1006,16590.8679978,15,0,15,2,5.24444294569548e-06,0.0097424857347354
642,1008,16858.7678576,18,4,22,3,1.27610292111058e-06,0.00537112700991074
643,1011,23125.1768657,47,3,50,7,1.59030696522677e-06,0.00602890915664842
644,1012,13974.3190459,19,1,20,2,1.58318243848043e-06,0.00605993624884727
645,1013,12805.5687153,17,17,34,9,1.4468396329903e-06,0.0059539596016081
646,1014,19001.3719376,22,13,35,5,1.6289736777253e-06,0.00649466122854468
647,1015,20920.4415561,6,8,14,2,1.77778883880819e-06,0.00664023167474272
648,1016,29112.3087343,70,9,79,12,2.454990408296e-06,0.00727120834890237
649,1017,5144.8154723,15,0,15,2,7.57112502469681e-07,0.00486687240173157
650,1018,8627.72802061,5,8,13,5,9.25284894037759e-07,0.00487766486353302
651,1019,11110.6831296,2,3,5,1,1.00325405583135e-06,0.00531647272517981
652,1020,7498.81955712,1,0,1,1,8.80528659763513e-07,0.00458430722547958
653,1023,11237.9718833,1,3,4,1,1.02816102298675e-06,0.00421522713578347
654,1024,18522.9665082,16,4,20,4,1.46085039887112e-06,0.00832699437523305
655,1025,11743.3931802,6,6,12,5,1.00571378425229e-06,0.00502281530170281
656,1027,5784.89189843,17,34,51,7,4.4308490032563e-07,0.00367677054611262
657,1028,10626.1748075,16,0,16,3,7.89672867540503e-07,0.00414271355541063
658,1029,10565.6580649,1,0,1,1,9.7716429081629e-07,0.0052943704375808
659,1030,57262.4702421,223,29,252,21,6.89270200382452e-06,0.0122359605955907
660,1031,20254.0191471,8,0,8,4,8.62979959492804e-07,0.00382752086986807
661,1032,9493.70144573,57,5,62,9,9.08417860046029e-07,0.00392488595087107
662,1034,13725.6558906,5,0,5,1,1.24289135783329e-06,0.00512293318514236
663,1035,12268.0547253,22,0,22,4,1.24710095406044e-06,0.00512050809008023
664,1036,12047.1330193,7,0,7,2,1.23105883176322e-06,0.00511426131892842
665,1037,24146.4860701,168,39,207,33,1.48065146277077e-06,0.00569535305782717
666,1039,10493.5980282,32,0,32,7,8.47152932692552e-07,0.00392950294575529
667,1040,14862.5304683,16,13,29,3,1.53082055476261e-06,0.00489766089104023
668,1041,7542.87258797,50,73,123,6,5.69344138057204e-07,0.00321437657794554
669,1043,30454.4313683,186,84,270,11,1.89762613445055e-06,0.00559053325923148
670,1044,36592.8306645,9,4,13,2,1.85235967364861e-06,0.00552488159744452
671,1046,59715.3783298,9,7,16,2,5.84197096031858e-06,0.0108618117272406
672,1050,18599.7038501,10,2,12,4,1.72461477632169e-06,0.0058981243517582
673,1051,17853.3382073,4,2,6,1,1.50315008795587e-06,0.00571496424066695
674,1053,6899.58974171,12,5,17,3,5.68917130294722e-07,0.00310891444618391
675,1055,58820.9050068,254,26,280,6,1.49709194374736e-06,0.00488013720480888
676,1056,8918.20333848,121,12,133,6,7.69177859183401e-07,0.00431851582777027
677,1057,23317.7546412,140,32,172,24,2.13495604839409e-06,0.00742110086752559
678,1058,9191.00021314,28,0,28,2,5.95496203459334e-07,0.00308348522310589
679,1059,45186.7182533,55,7,62,18,2.64135405814159e-06,0.00792321224411549
680,1060,46209.3385871,3,0,3,1,1.56993519340176e-06,0.00652995675952301
681,995,9294.50527759,16,5,21,5,1.86418765224516e-06,0.00909536065504687
682,1061,42146.5478452,282,30,312,22,5.36157904207357e-06,0.0101898092689096
683,1062,55087.1487496,34,14,48,12,9.92885361483786e-07,0.004044628948051
684,1064,78864.3487894,27,8,35,17,3.03622437058948e-06,0.00798137194829852
685,1065,86105.0728104,98,24,122,14,2.22753760681371e-06,0.00643769124850162
686,1066,15821.2788372,15,5,20,7,5.09181063534925e-07,0.00307786242565735
687,1067,110492.105772,883,97,980,33,9.68130234468845e-06,0.0133293815170359
688,1068,78695.3387812,97,10,107,6,6.35442256680108e-06,0.011600515032273
689,1069,7765.79599085,34,9,43,4,1.06710831460077e-06,0.00516291312793306
690,1070,40157.2077791,236,16,252,7,1.29502268464421e-06,0.00537053876576273
691,1071,2288.66193281,15,0,15,2,2.68144503934309e-07,0.00221482961649812
692,1072,6194.29414692,3,0,3,1,8.01128408056684e-07,0.00399605701043902
693,1063,33426.7145827,4,5,9,2,1.25443739307229e-06,0.00442966584554262
694,1079,10129.1114821,131,16,147,2,1.11310464490089e-06,0.00459405866314523
695,1080,71400.5009382,299,23,322,42,6.28936595603591e-06,0.0110830192339849
696,1081,12835.9550396,4,0,4,2,1.59520504894317e-06,0.00517321847047307
697,1082,24507.7819869,134,10,144,8,3.39625739798066e-06,0.0102202606403157
698,1083,6918.05133645,82,4,86,8,8.61227363202488e-07,0.00408850957801642
699,1084,12468.4855708,41,2,43,11,1.02514286481892e-06,0.00478178765929997
700,1085,66428.4962329,224,40,264,18,1.15707944132737e-05,0.0135948704386879
701,1086,13527.4335141,28,19,47,9,1.22584424389061e-06,0.00496034651425783
702,1087,21355.8935376,77,12,89,11,1.81522955244873e-06,0.00583476520253825
703,1088,40576.6158319,132,32,164,19,3.58441047865199e-06,0.00796678818258527
704,1089,52578.4700604,15,5,20,3,1.98530642592232e-06,0.00613863534942437
705,1090,128006.693145,1669,22,1691,78,1.29229420053889e-05,0.0151800306087535
706,1091,34722.5157285,111,19,130,7,1.77142055690638e-06,0.00534828479665238
707,1092,31318.9944398,287,57,344,24,4.067013378517e-06,0.00922796017626931
708,1093,75168.8616711,323,19,342,46,7.22055528967758e-06,0.0130131316355999
709,1094,75271.5302691,267,70,337,19,9.3949020083528e-06,0.0141794831549924
710,1095,105564.239391,693,78,771,118,1.1248130704189e-05,0.0149930725153183
711,1096,38813.6080922,496,28,524,10,4.81503684568452e-06,0.00893988832514077
712,1097,69177.62142,495,186,681,17,7.52600408304716e-06,0.0121559246571393
713,1098,30873.7630066,108,0,108,11,3.60002240995527e-06,0.00875423607767294
714,1099,6812.55531933,19,0,19,2,1.23813242680626e-06,0.00482396072392588
715,1100,14828.9787801,51,0,51,7,1.25590349853155e-06,0.0049748825655092
716,1101,17020.975662,97,3,100,18,1.43814486364136e-06,0.005442504998816
717,1102,21144.506469,137,25,162,18,2.04833986572339e-06,0.00626878876034815
718,1103,7778.08525207,52,0,52,11,9.08145011635497e-07,0.00502354516577327
719,1104,17868.1893777,74,8,82,7,1.37657707455219e-06,0.00528367831157264
720,1105,9243.92574524,4,4,8,5,1.27382600112469e-06,0.00498140049095466
721,1106,17241.7004661,75,11,86,18,1.31988008433837e-06,0.00508410923077929
722,1107,14192.2469116,6,0,6,2,1.20136792247649e-06,0.00476661904312169
723,1108,19061.9815872,168,0,168,10,1.2802165656467e-06,0.00476491758145229
724,1109,4749.53124196,46,2,48,7,4.68326106783934e-07,0.00354297111003536
725,1110,28874.9091364,301,28,329,22,2.83769622910768e-06,0.00714529325091064
726,1111,17485.0814077,129,5,134,14,1.56786063598702e-06,0.00533426298787992
727,1112,17482.3235838,138,38,176,8,1.52014672494261e-06,0.00526474255676067
728,1114,18716.6456453,136,0,136,11,1.7314682736469e-06,0.00574074011335798
729,1115,13662.6151701,41,9,50,8,1.54344979819143e-06,0.00563892561770097
730,1116,12874.0134309,59,14,73,17,1.45133026308031e-06,0.00562992991255329
731,1153,79896.3218542,571,40,611,76,9.85540964393294e-06,0.0138037088850909
732,1154,103439.833042,397,94,491,62,7.82083134254208e-06,0.0141439514713844
733,1049,18934.4133346,11,4,15,5,1.63308413902996e-06,0.00726311668416187
734,1164,12428.083543,39,8,47,3,1.16344835987547e-06,0.00518678461720222
735,993,6320.08562129,5,0,5,2,9.49843433772912e-06,0.0154788184037302
736,1117,43445.3681132,31,18,49,11,2.24231553147547e-06,0.00598970059269882
737,1118,33126.4669776,484,1,485,17,1.18689331429778e-06,0.00442581651782722
738,1120,21422.8924882,61,6,67,1,2.17326578422217e-06,0.00635674160683187
739,1121,35909.551807,483,22,505,23,2.16730222746264e-06,0.00634694188871959
740,1122,83764.0656225,619,20,639,25,7.52345295040868e-06,0.0111687741065641
741,1123,43743.2350125,354,38,392,14,4.32828301200061e-06,0.0109376438374214
742,1126,1641.57818189,10,2,12,2,9.48939032241469e-07,0.00387206371289491
743,1127,6719.81863682,13,1,14,7,1.63594222613028e-06,0.00525847694237432
744,1132,17448.4745867,3,2,5,3,5.44381418876583e-06,0.0188673070120888
745,1133,7728.20418457,4,4,8,1,2.26983229367761e-06,0.00711005860676528
746,1135,10573.5881701,5,5,10,2,3.94485914512188e-06,0.00750902620807677
747,1139,11832.7918662,223,0,223,2,1.4487868611468e-06,0.00502891484799381
748,1140,34905.4622409,65,0,65,5,2.78898642136483e-06,0.00663536172715738
749,1141,35918.5917996,360,50,410,25,4.08128971685073e-06,0.00862119273299495
750,1142,17350.6848391,277,0,277,1,1.96042356037651e-06,0.00620706656657985
751,1143,30211.1061593,423,0,423,63,1.81902487383923e-06,0.00605978365185547
752,1148,19982.0219204,222,41,263,27,3.80919163944782e-06,0.00816340117809479
753,1149,32374.6238677,149,39,188,25,2.4819232748996e-06,0.0100069301724792
754,1150,54911.44959,149,55,204,28,3.33766001858749e-06,0.00903085550273036
755,1151,23724.8554807,66,11,77,11,1.93242885870859e-06,0.00584139328843692
756,1152,90456.8695381,682,241,923,48,1.15673337859334e-05,0.0160667177136316
757,1155,205472.502276,2063,172,2235,76,2.37992235270212e-05,0.0201703614958786
758,1156,158459.734718,476,66,542,58,1.25529099932464e-05,0.0149722149821862
759,1157,221222.561098,1235,134,1369,128,3.43488477483334e-05,0.0394172432816019
760,1158,63485.7658868,533,95,628,57,2.07142425097118e-05,0.0374475516779641
761,1159,93204.6667164,773,140,913,41,1.19782630463305e-05,0.0202756674027671
762,1160,22682.1024627,61,2,63,2,1.36350490720361e-06,0.00575959709336267
763,1161,36388.9675315,661,3,664,12,4.33649979640904e-05,0.0268481822464957
764,1162,5275.29139789,34,1,35,8,8.59895862959092e-07,0.00397737867940398
765,1163,45980.5503389,299,24,323,12,2.73131281574024e-05,0.0270426522617297
766,370,61704.4393248,633,17,650,28,1.34675174194854e-05,0.016036775263876
767,371,18667.4094058,41,41,82,6,1.49728339238209e-06,0.00623247154592854
768,372,4365.3587432,1,0,1,1,4.55583176517393e-07,0.00399412069134405
769,373,25290.6624918,230,36,266,22,1.67876942214207e-06,0.00634716063069142
770,374,2865.75479363,1,0,1,1,2.43519480136456e-07,0.00206276946828397
771,375,5498.85922191,12,1,13,1,5.62379682378378e-07,0.0030100408345942
772,376,8102.09039729,7,1,8,1,8.10176516097272e-07,0.00366327055793069
773,992,26018.1255067,80,56,136,5,3.4903350751847e-06,0.00754646302513931
774,990,19788.8048591,3,0,3,4,1.95049824469606e-06,0.00664098019868944
775,989,24877.8943316,4,45,49,1,2.51932897299412e-06,0.0068459006665507
776,381,16693.9983941,10,6,16,5,1.40048814500915e-06,0.00576786873138598
777,382,22425.451241,8,7,15,1,1.37114420795115e-06,0.00860092669883712
778,383,14502.7750495,49,47,96,15,1.41296595757012e-06,0.00506352909092448
779,384,4341.59391815,15,6,21,6,6.7088831201545e-07,0.0032300025740999
780,385,30548.1392224,7,4,11,1,2.71780754701467e-06,0.00793670270929122
781,389,34803.3582658,8,0,8,2,3.44116233463865e-06,0.00844897295152526
782,391,25041.4458295,156,39,195,2,1.81318027898669e-05,0.0203051078799509
783,392,4966.2732068,29,12,41,5,4.31855241913581e-05,0.027046359958276
784,394,538.66498549,1,6,7,1,1.29373461277282e-05,0.0151526917139445
785,1078,64733.5204171,566,19,585,19,1.85500307452457e-05,0.0175067643582155
786,1201,715.68141617,18,0,18,1,4.01001670979895e-07,0.00274886101444302
787,1204,9932.02837656,3,0,3,1,5.8925115808961e-07,0.00307182842309231
788,1208,33823.6581689,8,7,15,2,4.8985430112225e-07,0.00319518546167708
789,1209,35656.0655469,6,5,11,3,6.60968453303212e-07,0.00363587045944188
790,1212,10407.998673,6,4,10,3,4.91029368276941e-07,0.00290281766214967
791,1213,55135.3061138,486,45,531,7,6.35177138974541e-06,0.0102598600197076
792,1214,125351.63574,17,8,25,7,6.89570151735097e-06,0.0108357178946668
793,980,8407.08512918,62,25,87,2,3.01454292639392e-06,0.00743593622873452
794,979,2528.84994023,4,0,4,1,6.31348484603222e-07,0.00336133655295474
795,977,23938.6609942,54,23,77,24,2.17055367102148e-06,0.00692226268298718
796,975,9623.69263819,5,0,5,2,1.05789422377711e-06,0.00438128857952075
797,974,13643.2311255,5,6,11,1,1.15901775643579e-06,0.00451449782051033
798,973,9341.25444046,10,7,17,3,1.15201737571624e-06,0.00446880560660396
799,946,4712.09211041,6,0,6,4,4.28029125032481e-07,0.00266478957166552
800,945,5782.28564502,27,34,61,10,4.68573034595465e-07,0.00277113414569613
801,348,2936.39005674,6,11,17,5,2.96806319965981e-07,0.00227391245432841
802,942,9490.50276612,22,26,48,6,7.91616002970841e-07,0.00445366105527597
803,908,5427.13941734,2,0,2,1,7.02325905876933e-07,0.00366831794281818
804,905,31229.1065196,174,0,174,6,2.68150688498281e-06,0.00690298706708305
805,904,16082.4588379,48,27,75,6,1.12743100544321e-06,0.00544740660772903
806,903,25656.5909413,101,10,111,5,1.84067403097288e-06,0.00620574342264868
807,902,77375.3284952,90,179,269,23,1.07365485746413e-06,0.00584024777396573
808,901,93591.392113,593,762,1355,194,2.2121398615127e-06,0.00710694608217569
809,475,9730.06165253,4,3,7,3,8.29111741040833e-07,0.00391675815823818
810,473,17101.3054444,85,92,177,32,1.02932972367853e-06,0.00479064092993741
811,471,33230.0465627,209,61,270,46,1.4440906852542e-06,0.0051762778147346
812,470,34073.1002107,66,33,99,20,7.00772034178954e-07,0.00340647314557176
813,469,30701.9922221,155,110,265,43,7.4745730671566e-07,0.00357013781768244
814,468,61455.5889027,262,119,381,37,8.14733539300505e-07,0.00363282080218141
815,467,56620.842709,296,19,315,36,6.27040662948275e-07,0.00325031372073522
816,466,43460.9598434,102,111,213,26,6.52260496281087e-07,0.00326234940057809
817,465,74607.895702,2104,52,2156,34,8.49584466777742e-07,0.004652662839628
818,413,4564.70968992,41,24,65,15,2.24849372898461e-07,0.00256331411050571
819,302,52727.9245571,34,54,88,5,1.31548176796059e-06,0.00544491365659025
820,301,99395.9937714,16,5,21,5,7.04486683389405e-06,0.0110489641933006
821,300,81333.8272186,200,56,256,12,7.61027922635549e-06,0.0326728668503561
822,1076,417.00162242,0,5,5,1,2.36928144659032e-06,0.00624331261627554
823,347,1555.89288151,3,4,7,2,1.88676040124847e-07,0.00174402492173214
824,346,4179.94673806,74,3,77,3,2.99425664707087e-07,0.00228581937182492
825,1038,30468.3387333,403,84,487,19,2.14461942960043e-06,0.0075041453840591
826,1052,8084.83240772,17,1,18,3,9.17208126338664e-07,0.00422179153289364
827,976,31945.6779622,155,5,160,13,2.14775081985863e-06,0.00591106456628836
828,567,25449.3574499,139,27,166,24,7.82642473495798e-07,0.00366362002505343
829,28,235497.720416,5253,184,5437,238,2.41851375903934e-06,0.00644069860405841
830,330,11296.067687,24,1,25,3,2.62869889411377e-07,0.0022943250893957
831,824,1969.28020795,3,0,3,1,8.87423493622919e-06,0.0129094426847754
832,867,86206.6268659,932,740,1672,9,6.70344252284849e-06,0.0142916532907569
833,864,117356.44093,777,145,922,10,4.51330561190844e-06,0.00933597888770513
834,862,141683.244553,1883,1996,3879,58,1.76414359884802e-05,0.026681970381365
835,825,155245.088949,1090,1090,2180,41,9.34758736548247e-06,0.0188675775202677
836,870,31568.254023,411,602,1013,8,4.61669560536393e-06,0.0127633861086074
837,868,42606.7990209,69,28,97,7,2.25036715164606e-05,0.0391431786201547
838,665,58118.5912132,17,3,20,12,1.08526355688809e-05,0.0214064753268054
839,863,76223.1627435,1123,131,1254,98,1.36050980472646e-05,0.0180242441531044
840,393,4835.77268405,15,7,22,3,2.29450947699661e-05,0.0208197981278891
841,398,68142.0275438,175,43,218,37,2.81206712315907e-06,0.0074840073487123
842,360,80815.6257449,426,53,479,19,1.45926755976689e-05,0.018022174202096
843,363,2766.29209646,9,5,14,6,2.52201471084845e-06,0.00749964732110147
844,362,129831.687997,515,445,960,87,1.26701261251583e-05,0.0173344631260177
845,361,62305.9726938,899,17,916,23,1.28930778373615e-05,0.0235438826673174
846,865,41649.1226064,384,262,646,19,1.43370762089035e-05,0.0219264412160448
847,866,59575.1097125,177,27,204,8,1.38602144943434e-05,0.0183385889941766
848,146,0,0,0,0,2,1.52196889757761e-06,0.00807206649510283
849,1215,35.3956953,0,0,0,0,5.02477632835507e-07,0.00325276736650619
850,588,13289.0725191,0,0,0,0,1.29120144265471e-06,0.00553629974469634
851,194,6916.46185468,0,0,0,0,5.75293597648852e-07,0.00380212371429668
852,755,8355.9761965,0,0,0,0,6.96071765560191e-07,0.00526593967893037
853,711,5893.77290607,0,0,0,0,2.04370962819667e-06,0.00914033860089544
854,756,9248.97678611,0,0,0,0,7.45939814805752e-07,0.00598246748194703
855,607,6714.52155194,0,0,0,0,5.46420778846368e-07,0.00359713646720526
856,520,9480.18069737,0,0,0,0,6.33197942079278e-07,0.00384739152921559
857,758,2519.64576824,0,0,0,0,1.82657004188513e-07,0.00189794868534994
858,759,1259.70440116,0,0,0,0,1.01128534879535e-07,0.00127560869028524
859,760,1708.28562438,0,0,0,0,1.33903085952625e-07,0.00152678232276735
860,761,1367.08717165,0,0,0,0,1.40202246257104e-07,0.00184179168934165
861,169,50752.4355404,0,0,0,0,1.1396336958569e-06,0.00449173606278607
862,426,2184.63214642,0,0,0,0,1.81188624992501e-07,0.00203010069156508
863,425,4513.42123635,0,0,0,0,3.41979102813639e-07,0.00299706343108782
864,409,9254.73444107,0,0,0,0,2.62927642324939e-07,0.00207902903302907
865,341,6369.50979378,0,0,0,0,6.66767391521716e-07,0.00329228787844799
866,335,5308.02201444,0,0,0,0,1.74057277035899e-07,0.00191333454103164
867,334,7333.28264318,0,0,0,0,2.43692284129793e-07,0.00204973557796326
868,418,3927.0036507,0,0,0,0,3.51520156982588e-07,0.00276936582592264
869,328,6693.1427855,0,0,0,0,3.55397332896246e-07,0.00268686219238488
870,313,31371.7309238,0,0,0,0,1.21452467283234e-06,0.00638876030535602
871,312,40452.2499799,0,0,0,0,1.50415962707484e-06,0.00783426227114126
872,311,7530.79725296,0,0,0,0,2.84220732282847e-07,0.00278985355385646
873,235,12565.6531325,0,0,0,0,4.2145211409661e-07,0.00327652737362615
874,227,8442.06590241,0,0,0,0,8.09390257927589e-07,0.00476558681294238
875,219,14961.3611894,0,0,0,0,1.3214121281635e-06,0.00603862536533107
876,201,35351.5531179,0,0,0,0,1.03618685898255e-06,0.00466339790669872
877,199,8975.04264715,0,0,0,0,5.85263023822336e-07,0.00377973789581688
878,198,3478.0077275,0,0,0,0,1.40950214699842e-06,0.00513758974727224
879,812,14851.8251611,0,0,0,0,5.28591954207513e-07,0.00293273204853116
880,310,18868.5335768,0,0,0,0,1.01776458905078e-06,0.00573376184439123
881,309,24164.0352148,0,0,0,0,2.47866364588845e-06,0.0075728151799948
882,933,9446.94797613,0,0,0,0,9.24330834095599e-07,0.00424946760473844
883,930,10823.5376546,0,0,0,0,5.28889813722344e-07,0.00291368380752046
884,929,4580.41035595,0,0,0,0,5.42322140972828e-07,0.00306553328242959
885,928,4901.74823314,0,0,0,0,6.90567503625061e-07,0.00364316178186667
886,845,86224.9564999,0,0,0,0,5.76148477193783e-06,0.0119556938753031
887,842,13514.2595937,0,0,0,0,7.30002739146585e-07,0.00414619283590038
888,834,27877.7828574,0,0,0,0,1.07608912003343e-06,0.00575317508227739
889,831,12424.5938085,0,0,0,0,8.17489762994228e-07,0.00391276036285494
890,805,9009.43673075,0,0,0,0,2.63089987129206e-07,0.00224810805450906
891,804,18037.2988233,0,0,0,0,3.28043370245723e-07,0.00261575610114172
892,803,3273.27467112,0,0,0,0,2.64089067059103e-07,0.00206532867545658
893,987,36753.3435317,0,0,0,0,3.69773033526144e-06,0.0136138035737927
894,986,6284.93917918,0,0,0,0,6.86186922393972e-07,0.0048299989014045
895,966,9497.52709628,0,0,0,0,2.25091207539663e-06,0.00919727150993676
896,964,16000.0534165,0,0,0,0,1.23915197036695e-06,0.00509406192090132
897,963,4079.43427729,0,0,0,0,4.87026227347087e-07,0.00383435299096354
898,962,27694.0446718,0,0,0,0,2.36296909861267e-06,0.00679328534173717
899,960,31198.9676074,0,0,0,0,2.53382768278243e-06,0.00680297034206209
900,957,15188.6515859,0,0,0,0,2.03806439458276e-06,0.00621017939144205
901,956,27722.9045186,0,0,0,0,2.90020989268669e-06,0.00785001086354197
902,955,13933.9209247,0,0,0,0,1.44990099215647e-06,0.00571863869522412
903,954,7140.46400244,0,0,0,0,1.33302137328428e-06,0.00476085323989577
904,950,13491.835476,0,0,0,0,1.3355424925976e-06,0.0047696563049621
905,936,10117.2711441,0,0,0,0,9.14279098651605e-07,0.00421436887553369
906,934,7518.87494349,0,0,0,0,6.66806045046542e-07,0.00340173641621735
907,923,15525.2986959,0,0,0,0,1.9695235096151e-06,0.00681855426637815
908,922,19106.1194244,0,0,0,0,1.92959078049171e-06,0.00712110283757686
909,914,7993.11742899,0,0,0,0,1.01781643024879e-06,0.00501625542902951
910,910,7186.85118,0,0,0,0,8.60294221638469e-07,0.00428184219794517
911,909,5227.26449499,0,0,0,0,8.64281446411042e-07,0.00415676700480869
912,535,9345.39195916,0,0,0,0,7.96919266576879e-07,0.0037663811976199
913,536,7192.44205361,0,0,0,0,5.04824583913432e-07,0.00370670020782304
914,539,35123.0236717,0,0,0,0,1.86005763680441e-06,0.00591313221598866
915,985,2614.77563494,0,0,0,0,2.23924416786758e-07,0.00215814064272038
916,983,15508.3609154,0,0,0,0,1.80184088094393e-06,0.00701704824708055
917,997,40789.8497357,0,0,0,0,3.55121801476344e-06,0.00953136284048121
918,981,11861.2837049,0,0,0,0,1.32189325086074e-06,0.00513672149589223
919,519,4057.68659255,0,0,0,0,2.94109668175224e-07,0.00241143378956317
920,553,56777.5575185,0,0,0,0,3.68860946764471e-06,0.00841935060478913
921,557,3886.81145906,0,0,0,0,3.77649939764524e-07,0.00268960912729162
922,580,16633.092756,0,0,0,0,9.02297870197799e-07,0.0038923752880298
923,584,9805.12685451,0,0,0,0,7.57899670134066e-07,0.00358193300631786
924,593,4516.40647538,0,0,0,0,6.50345555186505e-07,0.00333613135237162
925,592,5732.71781072,0,0,0,0,6.23602772975573e-07,0.00323232598425697
926,595,12787.5586498,0,0,0,0,1.24093048725626e-06,0.0046612890370888
927,599,8344.88484723,0,0,0,0,6.81699020788074e-07,0.00335298625304491
928,601,7714.7479994,0,0,0,0,9.50692992773838e-07,0.00392236736471886
929,603,4824.56725854,0,0,0,0,7.26653524907306e-07,0.00341436033553596
930,604,5639.1916245,0,0,0,0,4.35708898294251e-07,0.00272289674053709
931,612,6191.07051048,0,0,0,0,6.30439899396151e-07,0.00321325147038656
932,613,12467.7615779,0,0,0,0,8.60914042277727e-07,0.00383250445149581
933,614,48924.980933,0,0,0,0,1.97881263375166e-06,0.00685966459739398
934,615,6942.45955968,0,0,0,0,9.45550709730014e-07,0.00399531330747728
935,616,33093.2964045,0,0,0,0,9.02176907402463e-07,0.0038972439732822
936,620,8258.67277158,0,0,0,0,7.61692263040459e-07,0.00359549342600433
937,621,11464.0287543,0,0,0,0,1.28963574752561e-06,0.00486951650074085
938,622,15192.3302924,0,0,0,0,1.01054001788725e-06,0.00404640462475735
939,625,117.12947588,0,0,0,0,4.52874792244984e-06,0.0087539794967005
940,631,37218.5056096,0,0,0,0,1.32003242470091e-06,0.00567467200211338
941,635,36076.3358807,0,0,0,0,1.45150670505245e-06,0.00497123849636527
942,653,28790.0671921,0,0,0,0,1.47264063343755e-06,0.00484169913274181
943,654,8917.43384956,0,0,0,0,9.41107373364503e-07,0.00430859454769512
944,655,8502.88337141,0,0,0,0,1.01523801276926e-06,0.00479423933902868
945,664,18836.6318641,0,0,0,0,4.25911821366753e-07,0.00263537568822066
946,668,1791.65331532,0,0,0,0,3.66483618563507e-07,0.00345921139311664
947,671,3170.19307996,0,0,0,0,6.57595592201687e-07,0.0035352645138679
948,675,14128.2693353,0,0,0,0,1.19314563562511e-06,0.0053049956574402
949,676,8254.61716535,0,0,0,0,8.5373858382809e-07,0.00411704592845826
950,677,3570.66475705,0,0,0,0,2.94781330012484e-07,0.00252727785115321
951,681,7467.38582571,0,0,0,0,6.17879322817316e-07,0.00353945652141915
952,682,11786.7213081,0,0,0,0,9.92341938399477e-07,0.00463907850266464
953,846,4856.29146394,0,0,0,0,6.60968453303212e-07,0.00342340716939569
954,847,3613.28447921,0,0,0,0,2.94224719254998e-07,0.00217365437090109
955,848,2885.15350903,0,0,0,0,2.9434886528179e-07,0.00218091969305105
956,852,2515.55052814,0,0,0,0,2.63536094280425e-07,0.00205967678696047
957,853,2579.66344804,0,0,0,0,2.98166014545131e-07,0.00219255943476472
958,854,5413.247575,0,0,0,0,5.49031938135158e-07,0.00330433156708135
959,855,3008.63658913,0,0,0,0,3.32954641635297e-07,0.00230310260194642
960,693,2458.1904554,0,0,0,0,7.80912159825675e-07,0.00481164600595672
961,694,8985.83335181,0,0,0,0,5.21942183695501e-07,0.00361165784251304
962,701,5023.14665976,0,0,0,0,4.39037194155389e-07,0.00323116391622333
963,703,5722.68123688,0,0,0,0,5.23123162565753e-07,0.00291799634583576
964,704,4126.45527608,0,0,0,0,4.00268163502915e-07,0.00352026770683678
965,705,8530.48482074,0,0,0,0,9.56042185862316e-07,0.00395719887149682
966,709,2760.42542209,0,0,0,0,3.70197994925547e-07,0.00250827886114067
967,719,8223.80952185,0,0,0,0,6.68248048896203e-07,0.00335507887848263
968,722,10527.5158131,0,0,0,0,1.4409870345844e-06,0.00489681975594321
969,723,9344.97575622,0,0,0,0,1.16186674858909e-06,0.00482022204446096
970,724,10831.6260187,0,0,0,0,1.19060632641776e-06,0.00484366088001791
971,725,3448.15797721,0,0,0,0,4.20067863160511e-07,0.00260298258547647
972,726,2909.88820676,0,0,0,0,4.29045940109063e-07,0.00263380753869488
973,731,9933.08585223,0,0,0,0,1.01136447483441e-06,0.00419230414674995
974,733,3858.53647792,0,0,0,0,3.04452896671137e-07,0.00333257301906161
975,734,7869.52626232,0,0,0,0,1.00549777926062e-06,0.00405535144988335
976,735,5887.54353445,0,0,0,0,8.13263341115089e-07,0.00365950409612641
977,736,13864.7328411,0,0,0,0,1.67385178428958e-06,0.00576073729141165
978,738,5252.77374478,0,0,0,0,7.52445430407533e-07,0.0037132673884154
979,742,4186.82056328,0,0,0,0,6.5530912252143e-07,0.00337010618623994
980,743,2790.64766272,0,0,0,0,3.9991664380068e-07,0.00253235531162142
981,744,7233.18508391,0,0,0,0,4.99560428579571e-07,0.00328986794566355
982,745,3770.0159357,0,0,0,0,6.43998646410182e-07,0.00329294775715815
983,748,14052.8088114,0,0,0,0,8.13186034065438e-07,0.00407696078690349
984,1007,1255.36966642,0,0,0,0,3.04208697343711e-06,0.00667910825157705
985,1009,13395.8729365,0,0,0,0,1.4025404198037e-06,0.00553340688654943
986,1010,25377.2753115,0,0,0,0,1.40859856401221e-06,0.00548294589913883
987,1021,3256.38216477,0,0,0,0,4.77212779514957e-07,0.00339556163479223
988,1022,14220.0844792,0,0,0,0,1.13039186544484e-06,0.00437587089379925
989,1026,7131.1331895,0,0,0,0,5.81324002268957e-07,0.00324838647750603
990,1033,178.72173052,0,0,0,0,3.98848669647123e-06,0.00843434162187183
991,1042,8889.10609088,0,0,0,0,1.10656492324779e-06,0.00416424020324552
992,1047,9868.06650896,0,0,0,0,6.4987125369953e-07,0.00340845605609293
993,1048,4260.62125725,0,0,0,0,4.97429482493317e-07,0.00286436155668374
994,1054,14735.7590927,0,0,0,0,6.24182575847954e-07,0.00322973250715348
995,1113,21312.4541011,0,0,0,0,1.62023115990451e-06,0.0055960107434721
996,1119,3868.59316706,0,0,0,0,1.1153192644997e-06,0.00433103830244316
997,1125,7542.70943932,0,0,0,0,3.08388780467794e-06,0.00759897917258415
998,1128,9053.5444355,0,0,0,0,2.93074435830931e-06,0.00828023444758706
999,1129,8748.51381945,0,0,0,0,2.63360016106162e-06,0.00794096267539504
1000,1130,13178.7113811,0,0,0,0,3.96837140215212e-06,0.00974155673558838
1001,1131,9945.34832481,0,0,0,0,3.12921292788815e-06,0.00980910635104718
1002,1134,6104.8471376,0,0,0,0,1.96620703718509e-06,0.00659893367525289
1003,1136,5849.70358444,0,0,0,0,1.63895583682461e-06,0.00526237107743626
1004,1137,5716.04008871,0,0,0,0,1.63620643434115e-06,0.00526295202549019
1005,1138,4655.46305355,0,0,0,0,1.35268783196807e-06,0.00491616214082909
1006,1144,126.19478774,0,0,0,0,2.1179043869779e-06,0.00629494515314212
1007,1145,7975.8501985,0,0,0,0,2.61638842857792e-06,0.00812218161476113
1008,1146,9478.6350672,0,0,0,0,2.79827372651198e-06,0.00840021320553914
1009,1147,5922.58157026,0,0,0,0,1.98886846192181e-06,0.00596960128097303
1010,377,6454.78694126,0,0,0,0,5.92087417317089e-07,0.00315982443992294
1011,991,8962.09171878,0,0,0,0,1.94080121218576e-06,0.00685379906791494
1012,988,4387.20572885,0,0,0,0,8.48769559524953e-07,0.00365414845259522
1013,378,3151.83435489,0,0,0,0,3.19223090627929e-07,0.0027062129143027
1014,379,19782.0469766,0,0,0,0,1.69987833942287e-06,0.00584221545427198
1015,380,4068.01318452,0,0,0,0,3.15804300043965e-07,0.00230898485940926
1016,386,20346.707555,0,0,0,0,2.17932711166213e-06,0.00593591123374034
1017,387,21736.6290982,0,0,0,0,1.25269980344456e-06,0.00569278646458798
1018,388,46900.8699141,0,0,0,0,3.94431344830082e-06,0.00828320674219934
1019,395,17010.7890351,0,0,0,0,3.17297144647455e-06,0.00787108651614342
1020,396,10139.3684843,0,0,0,0,1.53646988110268e-06,0.00511216921937093
1021,397,88.53820339,0,0,0,0,5.09248820890207e-07,0.00373050615329522
1022,1073,1915.28844342,0,0,0,0,6.83474809193285e-07,0.00333708087480655
1023,1202,10641.773264,0,0,0,0,4.99841462442419e-07,0.00292138248991195
1024,1203,9331.99678989,0,0,0,0,4.94581399834715e-07,0.00291017345481276
1025,1205,17662.4810514,0,0,0,0,6.42712620901875e-07,0.00344693031202016
1026,1206,16700.7418782,0,0,0,0,6.3444076658925e-07,0.00334053350896664
1027,1207,105.66561155,0,0,0,0,1.26505665321019e-06,0.00530340206669105
1028,1211,14793.2070973,0,0,0,0,3.98044903704431e-07,0.00262968044423383
1029,1124,3074.05484874,0,0,0,0,1.27025441543083e-06,0.00741034336506907
1030,978,11249.2030935,0,0,0,0,1.08414997157524e-06,0.0063952484632871
1031,972,7859.07923468,0,0,0,0,1.01555315268342e-06,0.00427261790238491
1032,971,10969.6196628,0,0,0,0,1.52799975694506e-06,0.00591852205826296
1033,970,6593.12836822,0,0,0,0,9.10055860003922e-07,0.00401294479943195
1034,969,7855.67539236,0,0,0,0,1.05415529105812e-06,0.00432885883959866
1035,944,7451.99281869,0,0,0,0,7.43924829293974e-07,0.00357838618252024
1036,943,8258.64022269,0,0,0,0,6.90401975589339e-07,0.0034549901870852
1037,907,5165.9089209,0,0,0,0,5.31684236193541e-07,0.00302289848821639
1038,906,3189.8839678,0,0,0,0,4.2308329284424e-07,0.00255113558535212
1039,412,12250.9343808,0,0,0,0,2.79501364275347e-07,0.00236676796967554
1040,869,29698.4388072,0,0,0,0,3.94227299693739e-06,0.0104847657683372
1041,390,1336.16752939,0,1,1,0,2.13877578971733e-05,0.0236267624997015
1042,240,0,0,0,0,0,4.20391597799608e-06,0.0145553870153013
1043,1210,0,0,0,0,0,7.91216280049412e-07,0.00362730712927982
1044,1216,0,0,0,0,0,7.70722181187011e-07,0.0038037904172809
1045,3,0,0,0,0,0,1.22315213957336e-07,0.00235245314984196
1046,99,0,0,0,0,0,3.82337020710111e-07,0.00292427381548013
1047,202,0,0,0,0,0,1.1658989933494e-06,0.00755693153060079
1048,197,0,0,0,0,0,1.1851366252813e-06,0.00448701358884013
1049,506,0,0,0,0,0,1.89951606444083e-07,0.00221689184547802
1050,559,0,0,0,0,0,1.93615051102825e-07,0.00182611318563493
1051,663,0,0,0,0,0,3.22826053889003e-07,0.00334786028993918
1052,1045,0,0,0,0,0,2.02241881197551e-06,0.00627136403055038
1053,996,0,0,0,0,0,7.57382167648757e-07,0.00465601192599463
1054,994,0,0,0,0,0,4.7558037294948e-06,0.0105084526292571
1055,1074,0,0,0,0,0,5.60774878977099e-07,0.0030715477002435
1056,1075,0,0,0,0,0,7.57487214286812e-07,0.00354266385555259
1057,1077,0,0,0,0,0,2.49459708356881e-06,0.00753797316269418
