OBJECTID,BLOCKNUM,InternalFloorArea,FullTimeEmployees,PartTimeEmployees,TotalEmployees,Businesses,Shape__Area,Shape__Length
1,240,54.50151137,1,2,3,1,4.20E-06,0.014555387
2,239,56082.63699,233,21,254,9,4.15E-06,0.011447296
3,98,94483.93708,2295,155,2450,56,5.29E-07,0.003178732
4,97,122147.1334,2314,419,2733,146,9.55E-07,0.003918989
5,96,131083.6838,2440,503,2943,151,9.81E-07,0.003964375
6,39,152122.2896,4024,59,4083,45,7.24E-07,0.003523014
7,38,17003.3491,451,50,501,1,2.69E-07,0.002057735
8,37,13588.58872,279,84,363,1,3.23E-07,0.002273193
9,36,50320.14573,1274,133,1407,147,3.50E-07,0.002581298
10,35,116012.798,3398,318,3716,44,9.62E-07,0.004007921
11,34,146854.7678,5269,197,5466,31,1.26E-06,0.004773826
12,33,26250.59185,744,79,823,25,3.89E-07,0.002459428
13,32,72614.88416,694,155,849,12,8.52E-07,0.003855372
14,31,127617.4089,4003,111,4114,41,7.97E-07,0.003879565
15,30,53077.74653,1000,223,1223,91,7.24E-07,0.003989461
16,29,189958.7778,4354,348,4702,186,2.19E-06,0.006143877
17,27,70430.76051,491,221,712,18,9.78E-07,0.004511119
18,26,138165.64,3446,235,3681,39,7.52E-07,0.003796973
19,25,63017.52024,629,145,774,12,5.48E-07,0.003438801
20,24,44009.27902,64,1,65,17,3.51E-07,0.003476793
21,23,72317.7655,176,37,213,25,2.17E-07,0.002121904
22,22,61762.36614,164,155,319,4,4.16E-07,0.002764837
23,21,125449.4728,780,269,1049,73,1.69E-06,0.00873569
24,20,30080.98938,327,200,527,42,3.05E-06,0.017817583
25,19,19096.46842,333,48,381,37,7.63E-07,0.004050705
26,18,35059.10776,912,126,1038,26,8.57E-07,0.004836996
27,17,13654.54176,40,38,78,7,1.19E-06,0.004821208
28,16,32627.96236,588,228,816,41,1.38E-06,0.00544198
29,15,18938.2599,140,161,301,39,8.36E-07,0.00374072
30,14,9715.179149,107,102,209,12,5.53E-07,0.004093125
31,13,4694.229107,55,131,186,4,4.23E-07,0.003125727
32,12,20179.46266,259,166,425,20,2.71E-06,0.01065582
33,161,209920.8765,6648,144,6792,20,1.35E-05,0.01887989
34,191,106164.8177,149,56,205,9,2.84E-06,0.010049137
35,241,87614.5739,599,853,1452,117,1.16E-05,0.030552559
36,1216,38018.79153,3,7,10,2,7.71E-07,0.00380379
37,606,15060.55274,84,3,87,6,1.31E-06,0.005590112
38,343,6661.48972,32,30,62,7,5.12E-07,0.003047984
39,342,7677.403209,2,2,4,1,4.34E-07,0.00276096
40,196,69884.10054,446,12,458,39,1.43E-06,0.004939268
41,195,11968.44279,29,20,49,5,1.26E-06,0.004710039
42,193,26294.88031,14,4,18,8,1.21E-06,0.004862023
43,192,60355.41908,81,50,131,18,1.42E-06,0.004905613
44,190,2470.421879,5,1,6,2,1.21E-06,0.008409662
45,189,23140.98447,5,0,5,12,1.29E-05,0.015693388
46,188,20879.94768,69,0,69,6,1.93E-06,0.00550772
47,95,111102.9563,1368,153,1521,45,1.94E-06,0.005451206
48,94,68075.77803,1101,164,1265,68,8.96E-07,0.003777615
49,93,28479.49453,182,116,298,16,4.85E-07,0.002952686
50,71,134992.6782,2664,160,2824,104,1.16E-06,0.004564401
51,70,69717.54335,1063,89,1152,55,5.89E-07,0.003798464
52,69,89374.59632,2451,267,2718,134,7.30E-07,0.003894518
53,68,156671.1303,3086,239,3325,110,1.67E-06,0.005183436
54,67,202733.1964,6073,336,6409,53,1.57E-06,0.00496469
55,66,103764.2421,2852,286,3138,59,7.11E-07,0.003355195
56,65,28331.40071,746,106,852,93,4.65E-07,0.00278578
57,64,45411.50865,1189,58,1247,45,4.51E-07,0.002896818
58,63,42038.64195,1232,72,1304,94,4.86E-07,0.002852163
59,62,102011.0949,2049,181,2230,81,8.92E-07,0.004653381
60,61,179712.8244,4575,742,5317,97,1.43E-06,0.005183727
61,60,12081.80318,149,106,255,9,6.12E-07,0.004276233
62,59,148739.4733,1912,329,2241,17,4.85E-06,0.011183717
63,58,133748.8359,3552,263,3815,153,8.97E-07,0.003839917
64,57,57855.60695,2168,15,2183,30,5.01E-07,0.003168726
65,56,76960.57418,580,290,870,45,5.87E-07,0.003382395
66,55,238642.0792,6473,417,6890,375,1.76E-06,0.00529916
67,54,252693.0699,6746,755,7501,476,1.99E-06,0.005705152
68,53,140236.5101,2304,372,2676,237,1.26E-06,0.005275039
69,52,23469.78933,174,98,272,36,6.69E-07,0.004254019
70,51,86850.22748,1466,189,1655,132,7.53E-07,0.003837557
71,50,82710.91541,2572,415,2987,38,6.65E-07,0.00371745
72,49,140387.7533,5170,67,5237,38,1.10E-06,0.005423505
73,48,94104.3437,2748,163,2911,61,7.14E-07,0.004868224
74,47,45768.26252,479,76,555,17,3.14E-07,0.002200501
75,46,143882.2895,3236,358,3594,157,9.55E-07,0.004414115
76,45,122410.4898,3151,431,3582,134,9.04E-07,0.00386947
77,11,270554.6513,5261,247,5508,129,2.32E-06,0.008821857
78,10,52109.81139,78,43,121,20,6.08E-06,0.011799268
79,9,26429.40249,122,66,188,13,1.42E-06,0.006115653
80,8,4304.277067,159,0,159,4,2.66E-07,0.002633364
81,7,7521.570998,3,18,21,1,7.63E-07,0.00422596
82,6,9329.101379,15,37,52,3,2.25E-07,0.001856952
83,5,72098.83271,1381,97,1478,28,1.38E-06,0.006866528
84,4,14193.47879,4,5,9,2,9.51E-07,0.005294494
85,2,17094.46941,128,27,155,8,2.67E-06,0.007127623
86,1,26762.31968,41,2,43,9,1.80E-06,0.008336765
87,799,4800.792164,5,4,9,5,3.85E-07,0.003029781
88,798,8518.996139,14,5,19,4,5.10E-07,0.003007541
89,727,8171.97127,13,13,26,6,8.48E-07,0.00668898
90,718,19528.18803,42,44,86,13,2.63E-06,0.00723912
91,717,18800.57714,124,106,230,40,8.01E-07,0.004437937
92,710,4754.74716,5,6,11,1,3.72E-07,0.002955783
93,687,8947.849486,30,9,39,2,7.42E-07,0.005847495
94,587,14846.21958,61,22,83,20,1.24E-06,0.007025905
95,523,75231.21764,1846,208,2054,36,1.28E-06,0.004669049
96,522,45169.61619,66,41,107,10,3.68E-07,0.003441596
97,521,20183.21358,284,7,291,9,2.82E-07,0.002363792
98,504,7704.013876,1,2,3,1,6.44E-07,0.003881361
99,501,3929.595542,3,4,7,2,2.89E-07,0.002528055
100,459,57291.95411,384,135,519,10,2.23E-06,0.005907532
101,458,23210.52053,513,52,565,38,9.83E-07,0.004142414
102,187,13179.02433,122,10,132,5,6.06E-07,0.003164881
103,168,39168.46227,399,80,479,3,2.48E-06,0.008607261
104,167,21505.32948,227,64,291,11,6.74E-07,0.003921748
105,147,38829.83049,1313,64,1377,22,5.74E-07,0.003283615
106,145,226097.6172,781,182,963,156,1.24E-06,0.004434216
107,133,12783.66272,50,12,62,2,5.33E-07,0.004001114
108,132,36235.57908,83,34,117,11,4.57E-07,0.003076226
109,131,59644.01515,189,51,240,25,4.78E-07,0.003185847
110,130,149493.5636,2577,213,2790,25,1.06E-06,0.004340004
111,129,93075.53794,697,117,814,50,8.28E-07,0.003917757
112,128,62800.47581,677,15,692,6,5.72E-07,0.003462042
113,127,142060.6506,2116,462,2578,138,1.11E-06,0.004292685
114,126,410007.809,6389,917,7306,226,1.88E-06,0.005491123
115,125,118779.2121,3200,158,3358,55,9.10E-07,0.004939184
116,124,176673.3016,3545,264,3809,141,1.55E-06,0.005523112
117,123,31256.56148,465,336,801,112,1.10E-06,0.004307992
118,113,250604.3245,5752,687,6439,83,5.06E-06,0.011109396
119,112,3413.149213,27,15,42,4,2.07E-05,0.027485577
120,110,27919.08967,267,200,467,8,2.48E-06,0.015687641
121,109,6447.543411,26,5,31,4,8.01E-06,0.011002533
122,108,16574.95936,22,16,38,5,3.08E-06,0.007901679
123,106,26275.58123,85,12,97,3,1.56E-06,0.004864627
124,105,7290.184843,17,2,19,2,8.51E-06,0.011119552
125,104,69717.99263,237,59,296,4,8.86E-06,0.01280899
126,103,27555.14194,251,36,287,19,5.08E-05,0.044886148
127,101,5213.887822,23,3,26,11,3.98E-06,0.007767234
128,100,30934.74553,84,0,84,1,6.80E-07,0.004120666
129,44,131790.7961,1581,130,1711,76,8.26E-07,0.004448469
130,43,140426.8773,2498,259,2757,175,1.10E-06,0.004901712
131,464,67755.76546,449,113,562,19,6.50E-07,0.00313476
132,463,7322.145123,28,31,59,5,4.71E-07,0.00281797
133,460,33032.42336,5,3,8,3,6.35E-07,0.003905657
134,462,9221.911869,19,14,33,5,6.16E-07,0.003154885
135,461,10991.0349,37,9,46,3,2.91E-07,0.002218655
136,457,23068.2484,99,31,130,27,9.96E-07,0.004192623
137,456,17421.53756,162,57,219,27,1.00E-06,0.00421027
138,455,15066.7584,144,51,195,20,6.47E-07,0.003211858
139,454,56286.05721,249,138,387,43,9.36E-07,0.004651953
140,453,7992.881498,72,50,122,32,2.31E-07,0.002270641
141,452,17345.87167,184,106,290,38,5.86E-07,0.003119436
142,451,8626.568288,91,57,148,30,6.12E-07,0.003129369
143,450,16177.66591,31,30,61,11,9.72E-07,0.00416005
144,449,18037.58516,48,24,72,10,9.53E-07,0.004117112
145,448,7787.481865,13,13,26,5,9.26E-07,0.004059256
146,447,11875.13133,14,48,62,10,9.58E-07,0.0040949
147,166,9705.150671,45,6,51,5,6.62E-07,0.003460549
148,165,120730.9158,1505,342,1847,15,2.36E-06,0.00731321
149,164,133625.9488,686,220,906,35,1.64E-06,0.005797715
150,149,11621.07077,133,60,193,14,2.82E-07,0.002424981
151,163,8094.956279,3,0,3,1,5.47E-07,0.003000729
152,162,27321.43289,712,355,1067,4,1.13E-06,0.004901064
153,160,41730.17684,2,6,8,2,7.12E-07,0.00396051
154,159,22490.62485,92,63,155,26,5.34E-07,0.003362747
155,158,37481.33245,1456,2,1458,15,2.69E-07,0.002649551
156,157,1040.966041,12,0,12,8,2.41E-06,0.006284663
157,156,74773.26449,2286,150,2436,28,5.75E-07,0.003130196
158,155,35077.49587,28,11,39,6,2.75E-07,0.00258399
159,154,11267.24339,111,97,208,36,2.72E-07,0.002568996
160,153,68290.38133,834,186,1020,85,1.10E-06,0.004700701
161,152,16198.38804,208,98,306,39,3.17E-07,0.002305611
162,151,16014.28366,224,94,318,52,2.04E-07,0.00190103
163,141,23193.97951,4,1,5,1,4.77E-07,0.003107417
164,144,38624.48801,391,297,688,81,6.98E-07,0.003772988
165,142,29643.79519,50,92,142,19,3.49E-07,0.002394892
166,140,86743.45389,1132,277,1409,79,1.13E-06,0.005195058
167,139,32136.65441,284,246,530,113,8.34E-07,0.004395677
168,138,13070.75092,310,115,425,126,3.68E-07,0.002369803
169,137,37152.60116,720,355,1075,126,5.69E-07,0.00313723
170,136,28961.80215,134,207,341,40,7.09E-07,0.003717692
171,135,7193.275578,54,29,83,27,1.15E-07,0.001480991
172,134,28503.6498,39,10,49,3,1.99E-06,0.005575282
173,122,53680.61647,61,87,148,16,3.40E-07,0.002920137
174,121,113603.773,2034,106,2140,53,7.34E-07,0.003497077
175,120,127990.6783,560,435,995,187,1.37E-06,0.004749916
176,119,54324.98927,557,212,769,106,7.49E-07,0.003708252
177,118,44259.40357,61,89,150,32,3.71E-07,0.003034734
178,116,224508.8151,1000,441,1441,138,1.65E-06,0.005570253
179,115,160643.8594,375,214,589,62,1.49E-06,0.005389751
180,114,101036.2628,503,117,620,41,9.35E-07,0.004731641
181,111,109511.9659,826,183,1009,44,4.58E-06,0.027231547
182,353,3170.279023,29,1,30,8,1.38E-07,0.001727029
183,352,2224.793044,12,8,20,1,2.46E-07,0.002408227
184,238,101647.4178,502,195,697,16,3.46E-06,0.014314371
185,186,16765.82355,223,31,254,5,7.10E-07,0.003430224
186,185,32867.01402,518,69,587,14,9.86E-07,0.003973356
187,184,80417.60055,685,89,774,45,1.52E-06,0.004946726
188,183,130955.1753,1291,643,1934,107,3.50E-06,0.007743283
189,182,43162.20091,1347,20,1367,7,9.06E-07,0.003826543
190,181,117985.5858,935,1457,2392,8,2.71E-06,0.006777352
191,180,31815.01588,233,0,233,4,1.40E-06,0.004880301
192,179,75065.8992,1246,36,1282,11,2.71E-06,0.006650125
193,178,26371.10833,130,14,144,15,1.27E-06,0.004702192
194,177,25340.03628,14,9,23,5,1.23E-06,0.004722297
195,176,16699.20087,92,24,116,10,1.43E-06,0.00493545
196,175,88818.68276,669,139,808,158,1.42E-06,0.004931742
197,174,45422.28818,210,0,210,7,1.19E-06,0.004573606
198,173,25708.86769,165,16,181,14,1.26E-06,0.004702239
199,172,27240.88611,335,142,477,15,1.27E-06,0.004707528
200,171,8290.888707,26,10,36,6,5.75E-07,0.003801704
201,170,41277.93981,12,2,14,1,1.00E-06,0.004131053
202,169,48830.39748,38,142,180,8,1.14E-06,0.004491736
203,150,5500.626329,25,10,35,8,1.61E-07,0.002226509
204,148,157159.2746,307,2453,2760,142,1.43E-06,0.005159311
205,102,881.1993101,9,3,12,3,7.68E-06,0.011601234
206,91,159535.6225,2300,443,2743,221,1.12E-06,0.005583782
207,90,208524.699,2641,1040,3681,288,2.10E-06,0.00633201
208,89,300208.3419,7079,1699,8778,209,2.00E-06,0.006043708
209,88,65041.98652,398,388,786,163,5.17E-07,0.003963136
210,87,87928.58312,2441,366,2807,184,9.66E-07,0.004520642
211,86,69965.97236,637,250,887,61,7.48E-07,0.004186549
212,85,147234.906,2720,177,2897,86,1.30E-06,0.004843652
213,83,203080.1998,9894,555,10449,37,3.86E-06,0.008026925
214,82,18076.90433,104,37,141,4,2.23E-06,0.008228238
215,81,8468.979748,33,0,33,3,7.02E-07,0.004127225
216,80,83013.78102,1202,853,2055,162,7.15E-07,0.003768936
217,79,67318.60424,258,600,858,8,3.80E-06,0.011427302
218,78,258808.8383,4130,709,4839,347,1.78E-06,0.005421999
219,77,286599.2413,5480,2324,7804,374,1.96E-06,0.005720896
220,76,119715.6652,2777,699,3476,233,1.12E-06,0.004969971
221,75,122545.2956,2159,318,2477,182,1.09E-06,0.004965326
222,74,69178.18785,1516,252,1768,182,9.39E-07,0.004993495
223,73,223326.2152,4465,512,4977,68,1.57E-06,0.005491859
224,72,40792.74532,233,175,408,7,8.63E-07,0.005111704
225,42,105650.7381,1809,288,2097,83,7.82E-07,0.003884941
226,41,141771.7125,4846,275,5121,102,9.26E-07,0.004071071
227,40,194707.5735,4145,212,4357,190,1.39E-06,0.005235274
228,446,22056.26375,36,51,87,26,6.25E-07,0.003182553
229,445,18287.30124,34,16,50,16,1.00E-06,0.004261527
230,444,4618.826262,56,24,80,1,5.26E-07,0.003361216
231,443,10349.79698,2,0,2,1,7.92E-07,0.003503244
232,442,29149.86616,149,41,190,10,2.20E-06,0.006641307
233,441,8125.31185,56,38,94,18,3.95E-07,0.002673176
234,440,59154.6726,146,24,170,25,1.29E-06,0.005868779
235,439,13551.22062,58,21,79,19,3.88E-07,0.002545556
236,438,64277.62274,18,2,20,4,3.21E-06,0.007750664
237,437,14297.02674,90,61,151,8,4.71E-07,0.00296607
238,436,18918.00614,26,16,42,9,8.58E-07,0.003714638
239,434,24334.65917,214,2,216,13,2.82E-06,0.006837743
240,433,14076.39434,132,201,333,4,1.38E-06,0.007035019
241,432,7804.031434,67,15,82,12,2.21E-07,0.002288897
242,431,8470.387711,36,40,76,18,4.81E-07,0.002833439
243,430,26656.50388,92,117,209,23,1.11E-06,0.005888432
244,429,65603.07399,48,30,78,9,7.71E-07,0.005156036
245,428,11076.79067,124,74,198,29,3.60E-07,0.003392775
246,427,18215.99609,10,13,23,4,1.29E-06,0.005160364
247,424,32390.67189,289,23,312,12,1.70E-06,0.00961355
248,400,14407.50465,3,1,4,2,1.03E-06,0.007240854
249,423,24947.37535,297,82,379,6,8.27E-07,0.00370974
250,422,135304.9113,1903,400,2303,4,2.57E-06,0.007892434
251,421,4669.151238,76,1,77,3,3.63E-07,0.002788347
252,411,42999.65018,44,54,98,8,5.70E-06,0.010328847
253,410,17480.23574,3,2,5,1,5.72E-07,0.002993729
254,408,91078.8304,23,15,38,10,3.20E-06,0.00833744
255,407,130900.9785,336,366,702,24,4.01E-06,0.010580358
256,406,34579.0455,38,5,43,9,1.13E-06,0.004662529
257,405,12138.31849,16,27,43,12,2.95E-07,0.00264142
258,404,24281.91702,57,97,154,22,6.23E-07,0.003146241
259,403,26057.5324,167,134,301,56,9.41E-07,0.005356488
260,402,19313.91256,67,115,182,12,6.32E-07,0.0034129
261,401,97835.12348,144,178,322,41,1.40E-06,0.005410251
262,357,40693.76856,447,22,469,31,3.78E-07,0.002477004
263,356,27826.58798,3,4,7,1,3.91E-07,0.00248047
264,355,7263.971237,17,9,26,7,3.16E-07,0.002313147
265,354,48061.65715,187,46,233,22,1.28E-06,0.005033405
266,351,26364.2027,67,15,82,15,1.25E-06,0.005197159
267,350,73404.10478,619,75,694,60,1.19E-06,0.00478192
268,349,13682.00819,35,14,49,4,1.15E-06,0.004800276
269,345,1127.973849,14,5,19,1,2.47E-07,0.002069151
270,344,4640.363136,6,10,16,1,2.03E-07,0.002141018
271,340,10154.52232,22,14,36,8,1.20E-06,0.004439446
272,339,46499.13901,614,53,667,39,1.58E-06,0.005289418
273,338,32987.91356,271,77,348,4,1.75E-06,0.005480155
274,337,26540.94365,202,15,217,4,2.71E-06,0.007507511
275,336,7687.347331,66,47,113,7,5.06E-07,0.003023324
276,333,11317.36248,10,8,18,2,2.40E-07,0.002287687
277,332,25074.45687,9,4,13,3,1.06E-06,0.005645034
278,420,6723.238903,102,7,109,17,7.23E-07,0.003682115
279,419,8484.015936,13,16,29,2,7.05E-07,0.00343816
280,331,7473.905681,19,9,28,4,7.65E-07,0.005639834
281,329,16196.33071,31,11,42,11,7.88E-07,0.004953453
282,327,10416.36194,31,81,112,8,1.59E-07,0.001744245
283,326,44334.39059,150,104,254,22,1.53E-06,0.006596279
284,325,76095.99803,27,7,34,7,1.71E-06,0.007226339
285,324,35927.91128,187,272,459,44,5.52E-07,0.004749264
286,323,21254.97406,66,70,136,24,7.26E-07,0.004819631
287,322,20986.26085,23,17,40,8,4.86E-07,0.003430718
288,321,18438.23746,226,51,277,47,3.12E-07,0.002264375
289,320,39366.30425,115,99,214,48,8.08E-07,0.005095229
290,319,4405.703027,2,4,6,1,1.89E-07,0.001748606
291,318,16128.95171,44,99,143,8,5.43E-07,0.003228025
292,317,7761.910533,31,12,43,12,1.48E-07,0.001552411
293,316,18025.49884,57,66,123,23,5.72E-07,0.003055305
294,315,131899.1888,231,64,295,35,3.93E-06,0.009291902
295,314,20791.39228,27,28,55,5,6.90E-07,0.005174085
296,237,43663.77272,231,24,255,41,1.37E-06,0.005275271
297,235,12565.65346,4,3,7,2,4.21E-07,0.003276527
298,234,120761.9014,3307,390,3697,18,5.81E-06,0.01307598
299,233,46985.45424,1199,142,1341,105,2.32E-06,0.007959546
300,232,52334.9518,4,4,8,2,2.12E-06,0.006797713
301,231,34511.98727,22,27,49,8,1.25E-06,0.005006651
302,230,33153.7569,58,37,95,14,2.01E-06,0.005898855
303,229,15072.10628,62,41,103,18,1.61E-06,0.005999018
304,228,102494.3749,7,10,17,4,2.22E-06,0.006505603
305,226,211298.8726,1212,167,1379,19,6.82E-06,0.011369974
306,225,11049.78833,85,2,87,2,2.16E-06,0.010004929
307,223,22653.5516,311,218,529,38,4.53E-06,0.012725316
308,219,28313.52002,554,204,758,69,1.32E-06,0.006038625
309,218,13555.77046,106,2,108,4,9.44E-07,0.004882854
310,220,8485.906847,165,77,242,22,4.66E-07,0.004177756
311,217,18675.88402,401,168,569,32,1.18E-06,0.004760525
312,216,64372.36665,467,30,497,42,1.84E-06,0.006417185
313,215,273753.8036,2593,1016,3609,35,3.72E-06,0.008104929
314,214,10727.38102,56,47,103,10,3.41E-07,0.002553948
315,213,4990.338586,103,4,107,7,2.53E-07,0.002394868
316,212,83534.97472,1416,300,1716,22,1.55E-06,0.005009162
317,211,31182.76031,31,23,54,14,5.46E-07,0.003153203
318,210,43388.12542,365,101,466,26,7.13E-07,0.003498767
319,209,54303.15529,93,18,111,6,9.79E-07,0.004535559
320,208,6007.28683,209,4,213,3,2.32E-07,0.002325637
321,207,75797.6962,43,17,60,7,1.59E-06,0.005536808
322,206,113041.4095,183,76,259,33,1.23E-06,0.004667536
323,205,15909.12681,26,21,47,15,5.95E-07,0.003818827
324,204,71060.30445,53,24,77,19,7.72E-07,0.004709667
325,203,58577.6027,593,75,668,5,6.78E-07,0.00428928
326,201,35545.13854,14,0,14,1,1.04E-06,0.004663398
327,200,10080.35671,18,4,22,2,3.85E-07,0.002823074
328,198,4264.342218,1,1,2,1,1.41E-06,0.00513759
329,823,13278.0172,34,8,42,7,3.61E-07,0.002816166
330,822,9740.290526,6,0,6,2,8.42E-07,0.003918379
331,821,30964.47609,110,42,152,10,1.48E-06,0.00596293
332,820,13792.52986,31,1,32,3,8.16E-07,0.003704367
333,819,9349.825326,89,40,129,13,6.29E-07,0.003288461
334,818,3042.831284,1,4,5,1,2.83E-07,0.002760803
335,816,1976.59732,50,20,70,5,1.86E-07,0.002212599
336,815,10829.06343,24,9,33,6,4.39E-07,0.003164473
337,814,18584.16849,2,0,2,1,7.36E-07,0.003629275
338,811,9937.070256,116,24,140,13,4.62E-07,0.00311333
339,810,9994.3916,101,10,111,10,1.16E-06,0.004320841
340,809,12271.76907,63,3,66,12,4.28E-07,0.003039459
341,808,6978.191802,19,10,29,5,1.99E-06,0.005942534
342,797,5614.509394,10,2,12,1,6.18E-07,0.003542354
343,796,5743.510653,18,5,23,5,3.94E-07,0.003046044
344,795,7741.610246,62,6,68,6,3.21E-07,0.002772653
345,794,11667.56311,175,26,201,14,4.62E-07,0.002871865
346,793,4756.883037,29,7,36,7,3.57E-07,0.00247385
347,792,5383.703969,19,0,19,5,3.30E-07,0.002316277
348,791,15506.59784,69,4,73,9,6.26E-07,0.003313904
349,790,9464.07822,5,4,9,2,2.99E-07,0.003274863
350,789,12654.33671,154,68,222,17,8.17E-07,0.003654348
351,788,19346.95669,287,23,310,23,8.28E-07,0.004080661
352,787,14490.23871,91,13,104,14,6.17E-07,0.004074531
353,786,5004.086328,4,4,8,1,3.31E-06,0.007236284
354,785,13756.92117,76,14,90,8,2.07E-07,0.001951036
355,783,25145.16069,261,16,277,7,3.37E-07,0.00261982
356,782,2526.202437,11,11,22,3,1.02E-07,0.001556441
357,781,68308.82314,2499,48,2547,28,1.62E-06,0.005682043
358,780,19033.34562,106,16,122,21,2.94E-07,0.002736296
359,779,38519.46424,181,89,270,21,3.25E-07,0.002829677
360,778,91635.34886,731,114,845,26,1.83E-05,0.023147644
361,669,13479.20561,81,0,81,7,6.18E-07,0.003897461
362,646,13623.87288,59,4,63,3,2.89E-06,0.008672276
363,627,15298.53239,10,18,28,5,1.04E-06,0.007144807
364,757,15447.49748,2,5,7,3,1.03E-06,0.007173497
365,609,9433.436054,65,14,79,15,1.71E-07,0.002318633
366,610,19873.78442,368,169,537,14,2.88E-07,0.003628646
367,608,11580.71915,122,10,132,9,8.08E-06,0.013493176
368,308,96185.79809,706,289,995,12,2.40E-05,0.034941632
369,307,96172.397,646,7,653,18,2.55E-06,0.008059285
370,306,50433.33456,9,8,17,5,1.29E-06,0.005002935
371,305,95607.22008,33,13,46,6,2.84E-06,0.008369359
372,304,51263.25992,2,6,8,1,1.93E-06,0.007308424
373,303,31387.15879,38,42,80,13,7.98E-07,0.004008263
374,932,10682.60936,16,6,22,8,7.38E-07,0.003956072
375,931,3851.174061,23,2,25,2,5.97E-07,0.003276346
376,861,5310.604771,34,25,59,18,5.02E-07,0.002987249
377,860,19803.90227,111,43,154,24,1.36E-06,0.006077762
378,845,144134.9527,13,4,17,6,5.76E-06,0.011955694
379,844,64573.42805,367,75,442,14,4.25E-06,0.009279163
380,843,15445.60815,49,33,82,8,5.02E-07,0.004049536
381,841,10450.52961,14,3,17,5,7.89E-07,0.004185093
382,840,14505.33765,20,47,67,10,5.00E-07,0.003790589
383,839,25032.8823,91,48,139,23,7.64E-07,0.003777545
384,838,13841.89641,34,11,45,8,8.11E-07,0.003894893
385,837,27912.28779,34,1,35,1,5.86E-07,0.004036421
386,836,17985.79441,49,25,74,4,8.15E-07,0.004685999
387,835,17222.73798,138,33,171,14,9.13E-07,0.005060437
388,834,27795.10205,23,0,23,5,1.08E-06,0.005753175
389,833,32036.26413,314,9,323,8,1.41E-06,0.0062415
390,832,28529.20914,249,38,287,6,9.55E-07,0.00438423
391,830,109117.4593,490,33,523,10,7.85E-06,0.011383511
392,829,32306.70625,15,44,59,15,1.93E-06,0.007179736
393,828,18928.06572,5,31,36,8,5.81E-07,0.003410187
394,827,37672.72464,101,159,260,11,2.82E-06,0.008755944
395,826,9658.494701,72,17,89,10,7.62E-07,0.003935431
396,807,7895.421906,4,0,4,1,3.43E-07,0.00245266
397,806,12413.66939,25,2,27,6,5.12E-07,0.003005577
398,802,5186.030715,90,0,90,3,2.31E-07,0.001935156
399,801,11684.00122,184,16,200,12,4.11E-07,0.003053286
400,800,18267.38626,42,2,44,15,6.55E-07,0.003437711
401,565,27078.43948,523,70,593,41,3.92E-07,0.002607347
402,564,58811.55558,1744,110,1854,170,8.97E-07,0.003954953
403,563,7180.879409,51,52,103,31,2.73E-07,0.002593952
404,562,9014.84996,84,22,106,13,2.14E-07,0.002058354
405,561,21655.69766,98,48,146,35,4.12E-07,0.003406445
406,560,6782.290858,39,23,62,11,1.89E-07,0.001783028
407,987,40005.69411,3,15,18,1,3.70E-06,0.013613804
408,968,34064.79042,26,0,26,1,1.15E-05,0.014492367
409,967,31234.33287,2,0,2,1,3.49E-06,0.008188873
410,965,3768.625884,21,1,22,4,2.21E-07,0.002037419
411,961,7139.497955,4,11,15,1,4.74E-07,0.003202941
412,959,32360.15096,29,20,49,3,3.02E-06,0.007782512
413,958,26073.54896,84,38,122,36,2.57E-06,0.006468523
414,956,27179.27786,0,0,0,4,2.90E-06,0.007850011
415,953,17146.36037,22,8,30,5,1.88E-06,0.006237367
416,952,27485.26072,121,227,348,12,2.16E-06,0.006046405
417,951,28817.60914,35,19,54,16,1.74E-06,0.005380849
418,949,17947.83073,12,0,12,2,2.46E-06,0.006809591
419,948,11567.62895,94,93,187,24,7.18E-07,0.003576025
420,947,9414.502888,32,2,34,4,6.54E-07,0.003466724
421,941,9047.175986,38,11,49,5,6.95E-07,0.003530039
422,940,9814.27049,1,2,3,1,7.23E-07,0.00357134
423,939,9423.999616,3,3,6,1,9.84E-07,0.004336083
424,938,3246.777412,60,0,60,1,2.74E-07,0.002107354
425,937,8833.599306,40,24,64,10,1.00E-06,0.00473036
426,935,10590.15404,24,4,28,3,6.41E-07,0.003347725
427,926,9352.715283,7,3,10,1,1.05E-06,0.004833045
428,925,20765.04526,76,57,133,39,1.25E-06,0.005386691
429,924,18293.93894,42,30,72,12,1.74E-06,0.006203137
430,921,10615.01225,7,4,11,1,1.01E-06,0.005400311
431,920,14404.29725,11,24,35,7,1.17E-06,0.004752494
432,919,9050.497076,15,25,40,7,8.44E-07,0.003897531
433,918,12078.55751,3,0,3,1,1.35E-06,0.004942744
434,917,37077.77354,249,22,271,14,1.52E-06,0.007627292
435,916,17866.08191,181,31,212,4,1.17E-06,0.005514356
436,915,19741.22856,89,12,101,5,2.04E-06,0.011260987
437,913,31467.51458,114,63,177,29,2.59E-06,0.008380105
438,912,7460.656303,43,30,73,9,9.73E-07,0.004104062
439,911,10570.59024,34,141,175,20,1.19E-06,0.004700635
440,472,14884.82235,44,35,79,21,5.58E-07,0.004195123
441,474,22535.5662,105,48,153,22,1.55E-06,0.005508312
442,491,13116.05589,22,24,46,8,4.84E-07,0.002837522
443,492,25243.10364,234,22,256,18,6.00E-07,0.003094052
444,494,16183.36801,71,10,81,9,5.80E-07,0.003162201
445,495,7304.611314,133,4,137,6,4.52E-07,0.002674063
446,496,19599.56426,178,13,191,16,1.08E-06,0.004475293
447,497,34828.43829,163,17,180,15,1.62E-06,0.005797961
448,498,17748.65972,149,29,178,18,1.60E-06,0.005173971
449,499,21488.558,130,66,196,19,1.25E-06,0.004460195
450,500,10596.62202,16,12,28,4,6.72E-07,0.003749012
451,502,23909.85367,247,77,324,6,8.27E-07,0.003624883
452,503,18935.30579,25,9,34,7,1.33E-06,0.004760029
453,505,7801.367563,9,4,13,3,4.69E-07,0.003309106
454,507,21071.56983,106,37,143,12,9.45E-07,0.004877
455,508,21382.05459,65,19,84,8,9.24E-07,0.004041064
456,509,8717.705316,80,35,115,26,7.06E-07,0.003659243
457,510,19709.13751,38,1,39,9,1.43E-06,0.004938121
458,511,5664.932245,30,40,70,12,4.20E-07,0.003187671
459,512,28062.44848,42,12,54,8,6.05E-07,0.003300877
460,513,12651.18115,34,21,55,4,7.87E-07,0.003596364
461,514,22510.45304,155,50,205,24,8.35E-07,0.00371139
462,515,19102.32538,10,45,55,8,8.34E-07,0.005162627
463,516,16699.43614,125,44,169,22,8.00E-07,0.004024566
464,517,21251.71318,162,83,245,24,8.46E-07,0.004115399
465,518,31121.66086,484,200,684,56,8.71E-07,0.004206441
466,524,70673.871,877,537,1414,147,1.49E-06,0.00629574
467,525,11061.1352,73,27,100,21,5.28E-07,0.003272692
468,526,12795.82661,54,48,102,20,9.99E-07,0.004025367
469,527,2963.085065,35,0,35,1,5.39E-07,0.002994106
470,528,10906.37327,141,42,183,25,8.60E-07,0.00447634
471,529,14872.77496,228,38,266,31,4.95E-07,0.002803626
472,530,56351.68406,301,72,373,55,1.53E-06,0.005026472
473,531,8924.93937,48,13,61,14,8.07E-07,0.003695173
474,532,8622.895671,133,49,182,9,4.79E-07,0.002813753
475,533,3129.032036,1,1,2,1,2.55E-07,0.002297633
476,534,14132.37487,27,9,36,7,1.07E-06,0.004872237
477,537,14997.39254,79,28,107,11,1.09E-06,0.004705882
478,538,9661.722151,5,3,8,2,8.83E-07,0.005104659
479,540,22313.22206,11,15,26,1,2.01E-06,0.005963174
480,541,4580.700354,19,4,23,6,7.02E-07,0.004697213
481,984,15084.05079,42,25,67,3,1.05E-06,0.004697723
482,982,36800.65733,36,24,60,10,3.07E-06,0.007116915
483,493,19022.48397,83,21,104,26,1.05E-06,0.004214574
484,399,4661.673965,3,0,3,1,3.42E-07,0.003183951
485,417,22081.5128,21,0,21,6,2.05E-06,0.010593667
486,416,40093.99446,352,52,404,63,1.55E-06,0.006547474
487,415,19275.0956,94,3,97,7,1.46E-06,0.005634692
488,542,13176.38179,4,4,8,2,9.44E-07,0.004983935
489,543,11411.14024,22,0,22,5,9.66E-07,0.005059221
490,544,20157.19034,22,32,54,10,1.38E-06,0.005565203
491,545,26136.03024,158,63,221,55,1.67E-06,0.006253784
492,546,16888.19457,74,22,96,18,1.38E-06,0.004971451
493,547,14989.07909,21,8,29,4,7.25E-07,0.00433263
494,548,8745.637934,25,16,41,4,6.13E-07,0.004156689
495,549,4278.691957,4,4,8,3,3.91E-07,0.003018515
496,550,9434.335346,97,39,136,27,1.09E-06,0.004204869
497,551,5475.56522,34,17,51,13,3.34E-07,0.002857482
498,552,5579.559889,12,5,17,6,6.44E-07,0.00338996
499,554,6628.283428,47,20,67,10,4.63E-07,0.002723774
500,555,23312.36386,34,5,39,6,7.65E-07,0.0036508
501,556,19036.20686,273,180,453,5,7.55E-07,0.004308289
502,557,3879.26152,6,0,6,2,3.78E-07,0.002689609
503,566,4102.246228,36,18,54,12,2.64E-07,0.002445846
504,568,4248.582979,62,23,85,12,1.41E-07,0.001528927
505,569,17968.20661,223,15,238,12,4.20E-07,0.002630677
506,570,22259.73654,336,116,452,67,5.56E-07,0.003000282
507,571,8231.372801,40,10,50,11,4.59E-07,0.002764227
508,572,23632.1126,117,7,124,4,6.52E-07,0.003254358
509,574,15464.36126,118,22,140,24,6.10E-07,0.003371959
510,573,22543.78728,49,16,65,16,6.40E-07,0.003178633
511,575,20899.86639,117,15,132,18,6.80E-07,0.003323047
512,576,7218.824172,9,11,20,4,2.52E-07,0.002243102
513,577,12917.86181,218,54,272,3,6.29E-07,0.00317455
514,578,25237.69447,24,25,49,7,8.59E-07,0.00414972
515,579,8409.932556,35,82,117,12,6.35E-07,0.003383503
516,581,5486.355381,5,2,7,2,4.99E-07,0.002913114
517,582,26390.48021,278,13,291,59,6.69E-07,0.003479607
518,583,3831.785473,32,22,54,3,3.37E-07,0.002326814
519,585,5500.562845,6,0,6,4,5.62E-07,0.003154953
520,586,20913.44935,105,46,151,28,1.05E-06,0.004330049
521,589,18887.91344,108,6,114,16,1.63E-06,0.005936945
522,590,129603.7478,53,21,74,11,4.66E-06,0.008483609
523,591,8557.627081,2,0,2,1,6.67E-07,0.003460341
524,594,6683.30577,7,8,15,2,5.90E-07,0.003162123
525,596,27455.20001,250,86,336,30,2.82E-06,0.006728684
526,597,8591.23646,132,156,288,26,1.36E-06,0.005084702
527,598,5766.368372,4,1,5,1,5.79E-07,0.003060025
528,600,5913.142086,2,1,3,1,7.71E-07,0.003596514
529,602,5632.914163,12,17,29,2,8.54E-07,0.003707817
530,558,36001.62,1147,339,1486,1,5.82E-07,0.003141851
531,490,12280.69799,196,26,222,18,2.70E-07,0.002352343
532,605,10130.3239,2,3,5,3,1.06E-06,0.004190215
533,611,5984.398951,43,7,50,8,4.13E-07,0.003490539
534,617,7932.574198,2,1,3,2,9.94E-07,0.004154914
535,619,4870.681231,53,23,76,7,2.83E-07,0.002674526
536,622,16288.53692,20,8,28,1,1.01E-06,0.004046405
537,623,3670.414425,2,4,6,1,1.05E-06,0.004174893
538,624,13532.12601,19,5,24,9,1.45E-06,0.005318799
539,625,3440.168586,6,6,12,1,4.53E-06,0.008753979
540,626,42383.50572,522,73,595,76,2.27E-06,0.007807062
541,628,81037.50595,1140,122,1262,6,3.35E-06,0.00772908
542,629,12211.23976,17,20,37,11,7.19E-07,0.003682542
543,630,10920.03024,37,6,43,10,7.18E-07,0.003713981
544,632,17727.52577,30,8,38,3,1.48E-06,0.005842724
545,633,9226.213468,8,0,8,1,9.16E-07,0.003843577
546,634,59530.38047,10,1,11,4,1.92E-06,0.005615466
547,636,31351.25996,36,1,37,1,2.18E-06,0.005863483
548,637,21949.56887,4,0,4,1,1.06E-06,0.004453207
549,638,17143.15807,311,25,336,12,8.42E-07,0.004157078
550,639,19187.49843,120,18,138,23,8.45E-07,0.004138396
551,640,14395.08722,22,3,25,5,1.47E-06,0.005458207
552,641,21828.98936,39,10,49,7,1.46E-06,0.005452758
553,642,17194.17481,29,4,33,6,8.41E-07,0.004160854
554,643,10499.21863,17,4,21,5,4.14E-07,0.00263758
555,644,25623.29804,337,33,370,18,1.16E-06,0.005030202
556,645,34088.53207,51,9,60,11,9.75E-07,0.004714933
557,647,10134.8649,118,25,143,30,7.56E-07,0.003800205
558,648,47167.8659,430,111,541,25,8.46E-07,0.003792797
559,649,15405.75718,53,53,106,27,7.64E-07,0.003870624
560,650,18165.29652,68,8,76,4,1.37E-06,0.005676272
561,651,8341.07409,87,24,111,8,1.63E-06,0.006592128
562,652,43900.33927,160,33,193,42,1.87E-06,0.008394831
563,656,19986.22685,138,40,178,33,1.33E-06,0.005263718
564,657,19400.53354,76,59,135,24,7.51E-07,0.003442864
565,658,1012.00247,7,4,11,3,3.30E-07,0.002331746
566,659,32025.11101,15,14,29,6,1.16E-06,0.005020175
567,660,11206.05891,65,4,69,8,5.92E-07,0.003338519
568,661,20999.3227,24,5,29,13,7.97E-07,0.003724938
569,662,7926.643037,33,4,37,6,5.73E-07,0.003080629
570,489,10772.00777,191,35,226,34,3.44E-07,0.002704368
571,488,2323.433197,2,0,2,1,1.37E-07,0.00161454
572,487,6401.931409,56,31,87,6,2.15E-07,0.001937417
573,666,3636.182781,6,2,8,1,2.17E-07,0.002550341
574,667,14940.59866,51,6,57,8,9.17E-07,0.005277461
575,670,5502.409238,20,5,25,5,3.68E-07,0.00335828
576,671,780.7202391,1,0,1,1,6.58E-07,0.003535265
577,672,4356.02821,7,8,15,1,4.74E-07,0.00375961
578,673,6088.82798,5,0,5,1,7.21E-07,0.004517484
579,674,9216.675684,6,1,7,3,8.34E-07,0.005168253
580,678,5541.630836,21,0,21,1,4.88E-07,0.003109426
581,679,10993.32316,28,16,44,6,6.99E-07,0.004622924
582,680,740.7252852,1,4,5,1,1.59E-07,0.002006611
583,682,11765.95096,0,2,2,1,9.92E-07,0.004639079
584,683,6100.15313,28,4,32,4,4.74E-07,0.004255861
585,684,13627.07581,30,15,45,17,1.08E-06,0.004832541
586,685,5079.113538,51,0,51,2,3.13E-07,0.002987397
587,686,13442.48077,49,12,61,8,1.31E-06,0.005526064
588,688,35460.07134,221,131,352,14,3.52E-06,0.007851103
589,689,21547.5917,2,2,4,1,1.57E-06,0.005669457
590,849,5433.80921,31,6,37,14,4.14E-07,0.002642232
591,850,3070.101225,17,14,31,11,1.97E-07,0.001829317
592,856,3535.06072,0,1,1,1,2.96E-07,0.002155507
593,857,6224.838283,30,45,75,15,3.69E-07,0.002464193
594,858,8665.710295,28,76,104,22,9.00E-07,0.003852772
595,859,6698.754713,0,5,5,1,5.79E-07,0.003533716
596,690,11517.72025,28,39,67,10,1.02E-06,0.005201379
597,691,42533.9484,31,54,85,13,2.60E-06,0.007883474
598,692,7607.312491,2,1,3,2,6.39E-07,0.003224021
599,696,10407.29314,12,1,13,1,1.05E-06,0.004447739
600,695,18934.11147,54,34,88,17,6.77E-07,0.003602321
601,697,16207.71655,109,73,182,21,1.25E-06,0.005448038
602,698,18277.69296,73,139,212,23,1.25E-06,0.00478869
603,699,22597.35979,125,115,240,49,1.67E-06,0.006475429
604,700,5743.266871,29,66,95,17,1.95E-07,0.002091459
605,702,5833.094627,2,2,4,1,4.96E-07,0.00283513
606,703,5803.662111,1,4,5,1,5.23E-07,0.002917996
607,486,3320.186665,32,0,32,1,1.07E-07,0.00149885
608,484,20737.12928,466,46,512,30,4.45E-07,0.003024842
609,483,9312.298362,36,0,36,3,1.61E-07,0.001944758
610,482,4881.944487,47,0,47,4,1.83E-07,0.001796458
611,414,30280.44938,34,11,45,10,2.26E-06,0.007690044
612,706,9594.466969,12,25,37,2,1.26E-06,0.004599496
613,705,8529.898288,2,0,2,1,9.56E-07,0.003957199
614,707,15549.97459,10,2,12,2,1.24E-06,0.004532776
615,708,14462.29022,2,3,5,1,1.52E-06,0.005871219
616,712,3287.793388,0,1,1,1,4.04E-07,0.003171483
617,713,11546.24086,5,11,16,3,1.43E-06,0.005804335
618,714,5864.450632,2,2,4,4,6.39E-07,0.004602491
619,715,9524.729878,7,9,16,4,1.05E-06,0.004492867
620,716,8654.332204,5,15,20,1,1.17E-06,0.004732153
621,720,1882.25663,6,2,8,2,3.46E-07,0.002310875
622,721,31151.97654,172,83,255,39,4.73E-06,0.010416151
623,728,14587.80064,9,7,16,3,1.85E-06,0.006662697
624,729,10041.75244,16,14,30,8,5.18E-07,0.005524298
625,730,6801.567399,35,8,43,10,6.85E-07,0.003348507
626,732,8897.304956,20,16,36,5,6.41E-07,0.005683472
627,734,7907.785802,2,0,2,1,1.01E-06,0.004055351
628,735,5857.368346,2,0,2,1,8.13E-07,0.003659504
629,737,10339.23641,1,2,3,1,1.35E-06,0.005339287
630,739,4246.695978,57,67,124,15,3.58E-07,0.002857628
631,740,14453.72733,72,50,122,15,7.56E-07,0.004302859
632,741,9986.708947,16,13,29,7,6.05E-07,0.003235187
633,746,9549.44359,1,5,6,1,9.63E-07,0.00413522
634,747,12109.98342,20,21,41,8,1.14E-06,0.005815413
635,748,14039.53929,21,11,32,6,8.13E-07,0.004076961
636,751,4408.724541,1,1,2,1,6.28E-07,0.003377788
637,752,13935.13561,15,24,39,5,1.63E-06,0.005207093
638,753,21092.27276,12,10,22,4,1.60E-06,0.005610056
639,754,23764.03319,2,4,6,1,2.04E-06,0.006083761
640,1000,39450.01598,17,2,19,3,2.30E-06,0.007098957
641,1001,101082.2349,39,30,69,12,3.77E-06,0.00838841
642,1002,22194.0506,51,20,71,9,2.21E-06,0.00635004
643,1003,128376.7891,565,158,723,43,1.45E-05,0.01740425
644,1004,9566.511191,17,10,27,1,1.51E-06,0.005652454
645,1005,15135.34479,1,4,5,1,1.51E-06,0.005642735
646,481,18506.63543,82,2,84,4,2.39E-07,0.002001876
647,480,41176.43601,681,4,685,2,2.36E-06,0.006707305
648,479,8413.53233,214,93,307,23,7.81E-07,0.003507684
649,477,33294.15841,113,32,145,29,1.56E-06,0.005155151
650,478,75454.60694,140,63,203,20,2.40E-06,0.006294858
651,485,8629.109735,105,12,117,17,3.23E-07,0.002430357
652,476,11816.67707,14,12,26,4,5.21E-07,0.003879135
653,1006,16590.79971,25,5,30,2,5.24E-06,0.009742486
654,1008,16731.67218,15,5,20,3,1.28E-06,0.005371127
655,1011,23758.49852,46,5,51,6,1.59E-06,0.006028909
656,1012,14287.72774,3,1,4,1,1.58E-06,0.006059936
657,1013,12711.1369,20,29,49,8,1.45E-06,0.00595396
658,1014,19001.37182,25,10,35,3,1.63E-06,0.006494661
659,1015,20920.44149,5,6,11,2,1.78E-06,0.006640232
660,1016,30882.09551,91,34,125,12,2.45E-06,0.007271208
661,1017,5022.068483,23,11,34,2,7.57E-07,0.004866872
662,1018,9305.055893,4,6,10,3,9.25E-07,0.004877665
663,1019,11063.05971,2,5,7,2,1.00E-06,0.005316473
664,1020,7496.031961,0,1,1,1,8.81E-07,0.004584307
665,1023,11187.24913,3,2,5,1,1.03E-06,0.004215227
666,1024,18804.62122,11,3,14,4,1.46E-06,0.008326994
667,1025,11743.39342,8,9,17,4,1.01E-06,0.005022815
668,1027,5784.88824,17,34,51,7,4.43E-07,0.003676771
669,1028,10626.15006,16,0,16,3,7.90E-07,0.004142714
670,1029,10565.77145,3,0,3,2,9.77E-07,0.00529437
671,1030,55296.50705,196,60,256,20,6.89E-06,0.012235961
672,1031,20253.75195,6,30,36,5,8.63E-07,0.003827521
673,1032,8998.511107,35,17,52,6,9.08E-07,0.003924886
674,1034,13725.65569,1,4,5,2,1.24E-06,0.005122933
675,1035,12045.28823,17,21,38,8,1.25E-06,0.005120508
676,1036,11975.3384,9,0,9,3,1.23E-06,0.005114261
677,1037,24433.02337,115,33,148,30,1.48E-06,0.005695353
678,1039,10945.38987,64,1,65,13,8.47E-07,0.003929503
679,1040,14867.78506,26,11,37,4,1.53E-06,0.004897661
680,1041,7913.286556,128,14,142,6,5.69E-07,0.003214377
681,1043,31558.23638,261,75,336,18,1.90E-06,0.005590533
682,1044,35063.16214,143,36,179,9,1.85E-06,0.005524882
683,1045,286.5660429,0,6,6,1,2.02E-06,0.006271364
684,1046,60204.65247,21,4,25,2,5.84E-06,0.010861812
685,1050,18599.7031,11,5,16,5,1.72E-06,0.005898124
686,1051,17853.33821,5,2,7,1,1.50E-06,0.005714964
687,1053,6899.589882,10,6,16,3,5.69E-07,0.003108914
688,1055,60414.15711,236,26,262,4,1.50E-06,0.004880137
689,1056,8593.748269,166,10,176,6,7.69E-07,0.004318516
690,1057,21936.91172,170,20,190,31,2.13E-06,0.007421101
691,1058,9191.000121,31,3,34,4,5.95E-07,0.003083485
692,1059,43052.02111,119,41,160,27,2.64E-06,0.007923212
693,1060,99256.64319,71,103,174,17,1.57E-06,0.006529957
694,995,17745.73299,57,13,70,5,1.86E-06,0.009095361
695,1061,42625.4212,203,110,313,40,5.36E-06,0.010189809
696,1062,54904.26618,32,31,63,12,9.93E-07,0.004044629
697,1064,135184.0928,66,10,76,25,3.04E-06,0.007981372
698,1065,86787.84819,259,65,324,19,2.23E-06,0.006437691
699,1066,10422.44274,18,9,27,8,5.09E-07,0.003077862
700,1067,101059.6658,602,62,664,32,9.68E-06,0.013329382
701,1068,85831.81317,51,0,51,2,6.35E-06,0.011600515
702,1069,7630.631436,58,12,70,8,1.07E-06,0.005162913
703,1070,39676.14689,236,11,247,6,1.30E-06,0.005370539
704,1071,2360.592203,9,0,9,3,2.68E-07,0.00221483
705,1072,16045.01445,89,4,93,2,8.01E-07,0.003996057
706,1063,33139.00147,6,18,24,4,1.25E-06,0.004429666
707,1079,7012.935578,22,1,23,2,1.11E-06,0.004594059
708,1080,50387.77098,254,16,270,35,6.29E-06,0.011083019
709,1081,12846.75563,5,6,11,2,1.60E-06,0.005173218
710,1082,24464.63474,104,10,114,9,3.40E-06,0.010220261
711,1083,8470.588381,157,13,170,13,8.61E-07,0.00408851
712,1084,12200.24933,37,8,45,10,1.03E-06,0.004781788
713,1085,49045.20029,152,47,199,15,1.16E-05,0.01359487
714,1086,14094.40829,82,2,84,13,1.23E-06,0.004960347
715,1087,17940.21092,217,12,229,15,1.82E-06,0.005834765
716,1088,50978.19523,180,17,197,13,3.58E-06,0.007966788
717,1089,66954.28057,40,26,66,14,1.99E-06,0.006138635
718,1090,129160.7909,941,106,1047,90,1.29E-05,0.015180031
719,1091,43516.84589,76,7,83,12,1.77E-06,0.005348285
720,1092,31793.84803,225,29,254,20,4.07E-06,0.00922796
721,1093,63319.74044,397,90,487,59,7.22E-06,0.013013132
722,1094,58991.98405,211,103,314,20,9.39E-06,0.014179483
723,1095,104168.3254,780,85,865,132,1.12E-05,0.014993073
724,1096,37329.0233,708,11,719,12,4.82E-06,0.008939888
725,1097,63949.64088,801,167,968,25,7.53E-06,0.012155925
726,1098,31052.25846,111,2,113,9,3.60E-06,0.008754236
727,1099,7146.781837,17,2,19,2,1.24E-06,0.004823961
728,1100,14842.67303,65,5,70,9,1.26E-06,0.004974883
729,1101,17050.2238,141,7,148,22,1.44E-06,0.005442505
730,1102,25702.45606,249,31,280,28,2.05E-06,0.006268789
731,1103,7782.451158,43,27,70,9,9.08E-07,0.005023545
732,1104,19478.27389,35,6,41,6,1.38E-06,0.005283678
733,1105,10052.20253,10,18,28,5,1.27E-06,0.0049814
734,1106,17828.02552,53,25,78,19,1.32E-06,0.005084109
735,1107,14190.32269,4,2,6,2,1.20E-06,0.004766619
736,1108,18852.049,151,14,165,13,1.28E-06,0.004764918
737,1109,4749.530504,46,6,52,7,4.68E-07,0.003542971
738,1110,28874.79032,297,34,331,22,2.84E-06,0.007145293
739,1111,17206.95186,218,26,244,15,1.57E-06,0.005334263
740,1112,19475.78671,247,45,292,12,1.52E-06,0.005264743
741,1114,17981.2079,161,8,169,11,1.73E-06,0.00574074
742,1115,14893.67962,55,8,63,11,1.54E-06,0.005638926
743,1116,13396.26657,91,12,103,19,1.45E-06,0.00562993
744,1153,85540.02855,841,122,963,91,9.86E-06,0.013803709
745,1154,101948.9399,774,102,876,68,7.82E-06,0.014143951
746,1049,18939.61619,15,2,17,5,1.63E-06,0.007263117
747,1164,12417.43324,33,3,36,3,1.16E-06,0.005186785
748,993,6357.93969,5,0,5,1,9.50E-06,0.015478818
749,1117,45563.77609,74,17,91,11,2.24E-06,0.005989701
750,1118,33059.11716,711,7,718,43,1.19E-06,0.004425817
751,1120,21496.96244,31,7,38,4,2.17E-06,0.006356742
752,1121,35613.50044,279,29,308,23,2.17E-06,0.006346942
753,1122,128066.1519,775,127,902,35,7.52E-06,0.011168774
754,1123,41603.1129,459,53,512,14,4.33E-06,0.010937644
755,1126,1641.578182,5,2,7,1,9.49E-07,0.003872064
756,1127,6790.368569,11,8,19,7,1.64E-06,0.005258477
757,1132,17448.47459,3,2,5,2,5.44E-06,0.018867307
758,1133,7728.204185,2,5,7,1,2.27E-06,0.007110059
759,1135,10651.58772,5,5,10,2,3.94E-06,0.007509026
760,1139,13480.2976,92,0,92,1,1.45E-06,0.005028915
761,1140,14989.43704,144,0,144,11,2.79E-06,0.006635362
762,1141,40223.49722,338,22,360,25,4.08E-06,0.008621193
763,1143,30685.95348,519,9,528,63,1.82E-06,0.006059784
764,1144,84.88885802,0,2,2,1,2.12E-06,0.006294945
765,1148,20522.38054,189,41,230,27,3.81E-06,0.008163401
766,1149,32282.92711,175,36,211,33,2.48E-06,0.01000693
767,1150,54899.06666,170,28,198,31,3.34E-06,0.009030856
768,1151,24930.68428,163,26,189,23,1.93E-06,0.005841393
769,1152,79747.20137,896,211,1107,73,1.16E-05,0.016066718
770,1155,207242.8213,2830,255,3085,107,2.38E-05,0.020170361
771,1156,129831.8855,833,83,916,63,1.26E-05,0.014972215
772,1157,224239.1492,1164,251,1415,140,3.43E-05,0.039417243
773,1158,63847.88978,463,99,562,54,2.07E-05,0.037447552
774,1159,89183.547,888,39,927,44,1.20E-05,0.020275667
775,1160,22721.13308,74,2,76,2,1.36E-06,0.005759597
776,1161,40216.61311,485,121,606,16,4.34E-05,0.026848182
777,1162,5155.719208,8,1,9,4,8.60E-07,0.003977379
778,1163,56266.36462,405,8,413,17,2.73E-05,0.027042652
779,370,51820.04005,633,17,650,28,1.35E-05,0.016036775
780,371,19719.75579,45,41,86,7,1.50E-06,0.006232472
781,372,4365.358706,2,0,2,2,4.56E-07,0.003994121
782,373,25233.08523,286,35,321,27,1.68E-06,0.006347161
783,374,2865.754794,1,0,1,1,2.44E-07,0.002062769
784,375,5486.715472,16,0,16,2,5.62E-07,0.003010041
785,376,8102.090397,3,4,7,1,8.10E-07,0.003663271
786,992,35977.83811,37,10,47,6,3.49E-06,0.007546463
787,990,19148.4645,3,0,3,4,1.95E-06,0.00664098
788,989,24877.89433,6,45,51,1,2.52E-06,0.006845901
789,381,16580.27458,8,3,11,5,1.40E-06,0.005767869
790,382,22425.45145,3,0,3,1,1.37E-06,0.008600927
791,383,14665.95622,65,37,102,17,1.41E-06,0.005063529
792,384,4328.386806,22,7,29,6,6.71E-07,0.003230003
793,385,30548.13922,7,4,11,1,2.72E-06,0.007936703
794,389,34803.35827,8,0,8,2,3.44E-06,0.008448973
795,391,25297.47033,156,39,195,2,1.81E-05,0.020305108
796,392,4994.948551,40,16,56,7,4.32E-05,0.02704636
797,394,538.6649855,1,6,7,1,1.29E-05,0.015152692
798,1073,35643.03666,5,4,9,1,6.83E-07,0.003337081
799,1074,12629.24724,4,1,5,1,5.61E-07,0.003071548
800,1075,27828.51229,4,2,6,1,7.57E-07,0.003542664
801,1077,15684.14788,74,1,75,1,2.49E-06,0.007537973
802,1078,53168.63739,532,50,582,25,1.86E-05,0.017506764
803,1201,715.6813423,2,2,4,1,4.01E-07,0.002748861
804,1204,9932.028377,3,0,3,1,5.89E-07,0.003071828
805,1208,34166.56152,26,0,26,3,4.90E-07,0.003195185
806,1209,35656.06544,10,7,17,4,6.61E-07,0.00363587
807,1212,10407.99874,9,5,14,4,4.91E-07,0.002902818
808,1213,55231.96108,114,0,114,6,6.35E-06,0.01025986
809,1214,125351.6358,18,8,26,8,6.90E-06,0.010835718
810,980,9234.721279,138,17,155,2,3.01E-06,0.007435936
811,979,2528.84994,4,0,4,1,6.31E-07,0.003361337
812,977,24049.02732,55,48,103,25,2.17E-06,0.006922263
813,975,9623.692638,5,0,5,2,1.06E-06,0.004381289
814,974,13643.23113,5,6,11,1,1.16E-06,0.004514498
815,973,9362.68946,8,8,16,5,1.15E-06,0.004468806
816,946,4653.146328,5,2,7,2,4.28E-07,0.00266479
817,945,6034.515707,21,28,49,10,4.69E-07,0.002771134
818,348,2936.387583,23,0,23,4,2.97E-07,0.002273912
819,942,9522.601996,117,23,140,4,7.92E-07,0.004453661
820,908,5427.139445,2,0,2,1,7.02E-07,0.003668318
821,905,14437.94815,127,17,144,7,2.68E-06,0.006902987
822,904,15779.15034,27,22,49,7,1.13E-06,0.005447407
823,903,25662.77092,82,18,100,6,1.84E-06,0.006205743
824,902,80962.00062,124,165,289,30,1.07E-06,0.005840248
825,901,93641.64738,612,878,1490,204,2.21E-06,0.007106946
826,475,9730.061898,3,3,6,3,8.29E-07,0.003916758
827,473,17931.18044,132,181,313,45,1.03E-06,0.004790641
828,471,34643.79367,172,227,399,60,1.44E-06,0.005176278
829,470,34072.5728,62,46,108,19,7.01E-07,0.003406473
830,469,30957.74407,137,165,302,41,7.47E-07,0.003570138
831,468,69179.43913,165,89,254,32,8.15E-07,0.003632821
832,467,56639.28478,287,66,353,36,6.27E-07,0.003250314
833,466,43424.40259,78,63,141,27,6.52E-07,0.003262349
834,465,75056.98116,1982,98,2080,78,8.50E-07,0.004652663
835,413,4564.709687,41,22,63,16,2.25E-07,0.002563314
836,302,52695.56278,35,67,102,5,1.32E-06,0.005444914
837,301,100146.0954,16,5,21,5,7.04E-06,0.011048964
838,300,81274.88062,171,39,210,11,7.61E-06,0.032672867
839,347,1455.795241,6,8,14,2,1.89E-07,0.001744025
840,346,3850.31274,18,29,47,3,2.99E-07,0.002285819
841,1038,28907.11442,151,48,199,17,2.14E-06,0.007504145
842,1052,8084.833953,9,1,10,4,9.17E-07,0.004221792
843,976,32080.85173,130,41,171,12,2.15E-06,0.005911065
844,567,26129.96256,183,50,233,29,7.83E-07,0.00366362
845,28,234548.0265,5350,150,5500,276,2.42E-06,0.006440699
846,330,11209.46009,19,4,23,4,2.63E-07,0.002294325
847,824,1965.542082,3,62,65,1,8.87E-06,0.012909443
848,867,126646.1219,870,496,1366,11,6.70E-06,0.014291653
849,864,117361.1541,3680,250,3930,9,4.51E-06,0.009335979
850,862,142736.7853,1632,1915,3547,60,1.76E-05,0.02668197
851,825,165637.5162,1078,1062,2140,41,9.35E-06,0.018867578
852,870,32838.23463,315,588,903,8,4.62E-06,0.012763386
853,868,42305.75187,159,63,222,6,2.25E-05,0.039143179
854,665,58796.59562,29,409,438,13,1.09E-05,0.021406475
855,863,174320.8971,3348,114,3462,100,1.36E-05,0.018024244
856,393,4835.772747,12,7,19,2,2.29E-05,0.020819798
857,398,73765.64862,269,80,349,48,2.81E-06,0.007484007
858,360,86496.39977,311,39,350,15,1.46E-05,0.018022174
859,363,7491.509231,7,10,17,6,2.52E-06,0.007499647
860,361,63456.25276,841,22,863,29,1.29E-05,0.023543883
861,865,41986.98801,368,327,695,20,1.43E-05,0.021926441
862,866,59573.2652,163,22,185,8,1.39E-05,0.018338589
863,362,141995.9996,663,341,1004,81,1.27E-05,0.017334463
864,84,7424.528285,0,10,10,1,2.36E-07,0.002082462
865,146,0,0,0,0,1,1.52E-06,0.008072066
866,1215,35.3956953,0,0,0,0,5.02E-07,0.003252767
867,588,13289.07252,0,0,0,0,1.29E-06,0.0055363
868,194,6916.461855,0,0,0,0,5.75E-07,0.003802124
869,755,8355.976197,0,0,0,0,6.96E-07,0.00526594
870,711,5893.772906,0,0,0,0,2.04E-06,0.009140339
871,756,9248.976257,0,0,0,0,7.46E-07,0.005982467
872,607,6408.970185,0,0,0,0,5.46E-07,0.003597136
873,520,9480.180697,0,0,0,0,6.33E-07,0.003847392
874,758,2623.190671,0,0,0,0,1.83E-07,0.001897949
875,759,1259.704401,0,0,0,0,1.01E-07,0.001275609
876,760,1708.285624,0,0,0,0,1.34E-07,0.001526782
877,761,1367.087172,0,0,0,0,1.40E-07,0.001841792
878,435,6219.612048,0,0,0,0,2.93E-07,0.002436832
879,426,2184.632146,0,0,0,0,1.81E-07,0.002030101
880,425,4513.421236,0,0,0,0,3.42E-07,0.002997063
881,409,9254.734441,0,0,0,0,2.63E-07,0.002079029
882,341,6369.509794,0,0,0,0,6.67E-07,0.003292288
883,335,5236.814592,0,0,0,0,1.74E-07,0.001913335
884,334,7333.282643,0,0,0,0,2.44E-07,0.002049736
885,418,3927.003651,0,0,0,0,3.52E-07,0.002769366
886,328,6693.142786,0,0,0,0,3.55E-07,0.002686862
887,313,31371.73092,0,0,0,0,1.21E-06,0.00638876
888,312,40452.24998,0,0,0,0,1.50E-06,0.007834262
889,311,7530.797253,0,0,0,0,2.84E-07,0.002789854
890,236,40477.09306,0,0,0,0,1.34E-06,0.004727356
891,227,8442.065902,0,0,0,0,8.09E-07,0.004765587
892,199,8975.042647,0,0,0,0,5.85E-07,0.003779738
893,817,8293.92116,0,0,0,0,5.58E-07,0.003067873
894,813,8774.124377,0,0,0,0,4.45E-07,0.002728435
895,812,14851.82516,0,0,0,0,5.29E-07,0.002932732
896,784,13811.58579,0,0,0,0,5.21E-07,0.003741375
897,310,18868.53358,0,0,0,0,1.02E-06,0.005733762
898,309,24164.03521,0,0,0,0,2.48E-06,0.007572815
899,933,9488.375552,0,0,0,0,9.24E-07,0.004249468
900,930,10823.53823,0,0,0,0,5.29E-07,0.002913684
901,929,4580.410356,0,0,0,0,5.42E-07,0.003065533
902,928,4901.748233,0,0,0,0,6.91E-07,0.003643162
903,842,15103.83706,0,0,0,0,7.30E-07,0.004146193
904,831,15838.73705,0,0,0,0,8.17E-07,0.00391276
905,805,9009.436731,0,0,0,0,2.63E-07,0.002248108
906,804,18008.9677,0,0,0,0,3.28E-07,0.002615756
907,803,3273.274671,0,0,0,0,2.64E-07,0.002065329
908,986,6284.939179,0,0,0,0,6.86E-07,0.004829999
909,966,9497.527096,0,0,0,0,2.25E-06,0.009197272
910,964,16000.05342,0,0,0,0,1.24E-06,0.005094062
911,963,4079.434277,0,0,0,0,4.87E-07,0.003834353
912,962,27694.04467,0,0,0,0,2.36E-06,0.006793285
913,960,31198.96761,0,0,0,0,2.53E-06,0.00680297
914,957,15175.66125,0,0,0,0,2.04E-06,0.006210179
915,955,13933.92092,0,0,0,0,1.45E-06,0.005718639
916,954,7140.464002,0,0,0,0,1.33E-06,0.004760853
917,950,13491.83548,0,0,0,0,1.34E-06,0.004769656
918,936,10117.27114,0,0,0,0,9.14E-07,0.004214369
919,934,7518.874943,0,0,0,0,6.67E-07,0.003401736
920,927,8731.151078,0,0,0,0,1.01E-06,0.004430193
921,923,15525.2987,0,0,0,0,1.97E-06,0.006818554
922,922,19106.11942,0,0,0,0,1.93E-06,0.007121103
923,914,7993.117429,0,0,0,0,1.02E-06,0.005016255
924,910,7186.85118,0,0,0,0,8.60E-07,0.004281842
925,909,5227.264495,0,0,0,0,8.64E-07,0.004156767
926,535,9345.391959,0,0,0,0,7.97E-07,0.003766381
927,536,7192.442054,0,0,0,0,5.05E-07,0.0037067
928,539,35123.02367,0,0,0,0,1.86E-06,0.005913132
929,985,2614.775635,0,0,0,0,2.24E-07,0.002158141
930,983,15508.36092,0,0,0,0,1.80E-06,0.007017048
931,997,41182.54702,0,0,0,0,3.55E-06,0.009531363
932,981,11861.2837,0,0,0,0,1.32E-06,0.005136721
933,519,4057.686593,0,0,0,0,2.94E-07,0.002411434
934,553,56777.56537,0,0,0,0,3.69E-06,0.008419351
935,580,16633.09276,0,0,0,0,9.02E-07,0.003892375
936,584,9805.126855,0,0,0,0,7.58E-07,0.003581933
937,593,4516.406475,0,0,0,0,6.50E-07,0.003336131
938,592,5732.717811,0,0,0,0,6.24E-07,0.003232326
939,595,12787.55865,0,0,0,0,1.24E-06,0.004661289
940,599,8253.474933,0,0,0,0,6.82E-07,0.003352986
941,601,7714.747999,0,0,0,0,9.51E-07,0.003922367
942,603,4824.567259,0,0,0,0,7.27E-07,0.00341436
943,604,5639.191625,0,0,0,0,4.36E-07,0.002722897
944,612,6191.07051,0,0,0,0,6.30E-07,0.003213251
945,613,12467.76158,0,0,0,0,8.61E-07,0.003832504
946,614,48924.98093,0,0,0,0,1.98E-06,0.006859665
947,615,6942.45956,0,0,0,0,9.46E-07,0.003995313
948,616,33093.2964,0,0,0,0,9.02E-07,0.003897244
949,618,5494.539225,0,0,0,0,5.88E-07,0.003030377
950,620,8258.672772,0,0,0,0,7.62E-07,0.003595493
951,621,11464.02875,0,0,0,0,1.29E-06,0.004869517
952,631,37218.50561,0,0,0,0,1.32E-06,0.005674672
953,635,36041.91814,0,0,0,0,1.45E-06,0.004971238
954,653,28790.06719,0,0,0,0,1.47E-06,0.004841699
955,654,8917.43385,0,0,0,0,9.41E-07,0.004308595
956,655,8502.883371,0,0,0,0,1.02E-06,0.004794239
957,664,18836.63186,0,0,0,0,4.26E-07,0.002635376
958,668,1791.630165,0,0,0,0,3.66E-07,0.003459211
959,675,13913.9318,3,4,7,0,1.19E-06,0.005304996
960,676,8254.617165,0,0,0,0,8.54E-07,0.004117046
961,677,3570.664757,0,0,0,0,2.95E-07,0.002527278
962,681,7467.385826,0,0,0,0,6.18E-07,0.003539457
963,846,4856.291464,0,0,0,0,6.61E-07,0.003423407
964,847,3215.475933,0,0,0,0,2.94E-07,0.002173654
965,848,2885.153509,0,0,0,0,2.94E-07,0.00218092
966,851,3156.925887,0,0,0,0,2.67E-07,0.002064707
967,852,2515.550528,0,0,0,0,2.64E-07,0.002059677
968,853,2579.663448,0,0,0,0,2.98E-07,0.002192559
969,854,5413.247575,0,0,0,0,5.49E-07,0.003304332
970,855,3008.636589,0,0,0,0,3.33E-07,0.002303103
971,693,2458.190455,0,0,0,0,7.81E-07,0.004811646
972,694,9000.934327,0,0,0,0,5.22E-07,0.003611658
973,701,5023.14666,0,0,0,0,4.39E-07,0.003231164
974,704,4126.455276,0,0,0,0,4.00E-07,0.003520268
975,709,2760.425422,0,0,0,0,3.70E-07,0.002508279
976,719,8223.809522,0,0,0,0,6.68E-07,0.003355079
977,722,10851.90976,0,0,0,0,1.44E-06,0.00489682
978,723,9384.179866,0,0,0,0,1.16E-06,0.004820222
979,724,10831.62602,0,0,0,0,1.19E-06,0.004843661
980,725,3448.157977,0,0,0,0,4.20E-07,0.002602983
981,726,2909.888207,0,0,0,0,4.29E-07,0.002633808
982,731,9933.085852,0,0,0,0,1.01E-06,0.004192304
983,733,3858.536478,0,0,0,0,3.04E-07,0.003332573
984,736,13864.73293,0,0,0,0,1.67E-06,0.005760737
985,738,5252.773745,0,0,0,0,7.52E-07,0.003713267
986,742,4497.278808,0,0,0,0,6.55E-07,0.003370106
987,743,3195.127326,0,0,0,0,4.00E-07,0.002532355
988,744,7233.185084,0,0,0,0,5.00E-07,0.003289868
989,745,3846.077205,0,0,0,0,6.44E-07,0.003292948
990,1007,1255.369666,0,0,0,0,3.04E-06,0.006679108
991,1009,13395.87294,0,0,0,0,1.40E-06,0.005533407
992,1010,25377.27531,0,0,0,0,1.41E-06,0.005482946
993,1021,3401.195575,0,0,0,0,4.77E-07,0.003395562
994,1022,14220.08448,0,0,0,0,1.13E-06,0.004375871
995,1026,7131.132663,1,0,1,0,5.81E-07,0.003248386
996,1033,378.0738968,0,0,0,0,3.99E-06,0.008434342
997,1042,8889.106091,0,0,0,0,1.11E-06,0.00416424
998,1047,9868.066509,0,0,0,0,6.50E-07,0.003408456
999,1048,4260.621257,0,0,0,0,4.97E-07,0.002864362
1000,1054,14735.75909,0,0,0,0,6.24E-07,0.003229733
1001,1113,20260.46851,0,0,0,0,1.62E-06,0.005596011
1002,1119,4007.785157,0,0,0,0,1.12E-06,0.004331038
1003,1125,8071.525275,0,0,0,0,3.08E-06,0.007598979
1004,1128,9053.544436,0,0,0,0,2.93E-06,0.008280234
1005,1129,8748.513819,0,0,0,0,2.63E-06,0.007940963
1006,1130,13178.71138,0,0,0,0,3.97E-06,0.009741557
1007,1131,9945.348325,0,0,0,0,3.13E-06,0.009809106
1008,1134,6104.847138,0,0,0,0,1.97E-06,0.006598934
1009,1136,5849.703584,0,0,0,0,1.64E-06,0.005262371
1010,1137,5755.203919,0,0,0,0,1.64E-06,0.005262952
1011,1138,4655.463054,0,0,0,0,1.35E-06,0.004916162
1012,1142,17350.68826,0,0,0,0,1.96E-06,0.006207067
1013,1145,8154.29491,0,0,0,0,2.62E-06,0.008122182
1014,1146,9478.635067,0,0,0,0,2.80E-06,0.008400213
1015,1147,5922.58157,0,0,0,0,1.99E-06,0.005969601
1016,377,6454.786941,0,0,0,0,5.92E-07,0.003159824
1017,991,8962.091719,0,0,0,0,1.94E-06,0.006853799
1018,988,4387.205729,0,0,0,0,8.49E-07,0.003654148
1019,378,3151.834355,0,0,0,0,3.19E-07,0.002706213
1020,379,19782.04698,0,0,0,0,1.70E-06,0.005842215
1021,380,4068.013185,0,0,0,0,3.16E-07,0.002308985
1022,386,20346.70756,0,0,0,0,2.18E-06,0.005935911
1023,387,21736.6291,0,0,0,0,1.25E-06,0.005692786
1024,388,46900.86991,0,0,0,0,3.94E-06,0.008283207
1025,395,17010.78904,0,0,0,0,3.17E-06,0.007871087
1026,396,10139.36848,0,0,0,0,1.54E-06,0.005112169
1027,397,88.53820339,0,0,0,0,5.09E-07,0.003730506
1028,1202,10641.77326,0,0,0,0,5.00E-07,0.002921382
1029,1203,9331.99679,0,0,0,0,4.95E-07,0.002910173
1030,1205,17662.48105,0,0,0,0,6.43E-07,0.00344693
1031,1206,16700.74188,0,0,0,0,6.34E-07,0.003340534
1032,1207,105.6656116,0,0,0,0,1.27E-06,0.005303402
1033,1211,14793.2071,0,0,0,0,3.98E-07,0.00262968
1034,1124,3074.054849,0,0,0,0,1.27E-06,0.007410343
1035,978,11249.20309,0,0,0,0,1.08E-06,0.006395248
1036,972,7859.079235,0,0,0,0,1.02E-06,0.004272618
1037,971,10969.61966,0,0,0,0,1.53E-06,0.005918522
1038,970,6593.128368,0,0,0,0,9.10E-07,0.004012945
1039,969,7855.675392,0,0,0,0,1.05E-06,0.004328859
1040,944,7451.992819,0,0,0,0,7.44E-07,0.003578386
1041,943,8258.640223,0,0,0,0,6.90E-07,0.00345499
1042,907,5165.908921,0,0,0,0,5.32E-07,0.003022898
1043,906,3189.883968,0,0,0,0,4.23E-07,0.002551136
1044,412,12250.93438,0,0,0,0,2.80E-07,0.002366768
1045,1076,324.6159947,0,0,0,0,2.37E-06,0.006243313
1046,869,29698.43881,0,0,0,0,3.94E-06,0.010484766
1047,390,1336.167529,0,1,1,0,2.14E-05,0.023626762
1048,1210,0,0,0,0,0,7.91E-07,0.003627307
1049,3,0,0,0,0,0,1.22E-07,0.002352453
1050,99,0,0,0,0,0,3.82E-07,0.002924274
1051,202,0,0,0,0,0,1.17E-06,0.007556932
1052,197,0,0,0,0,0,1.19E-06,0.004487014
1053,506,0,0,0,0,0,1.90E-07,0.002216892
1054,559,0,0,0,0,0,1.94E-07,0.001826113
1055,663,0,0,0,0,0,3.23E-07,0.00334786
1056,996,0,0,0,0,0,7.57E-07,0.004656012
1057,994,0,0,0,0,0,4.76E-06,0.010508453
1058,92,0,0,0,0,0,9.48E-08,0.001302766
