OBJECTID,BLOCKNUM,InternalFloorArea,FullTimeEmployees,PartTimeEmployees,TotalEmployees,Businesses,Shape__Area,Shape__Length
1,25,62870.59915636,538,120,658,14,5.48145635548281e-07,0.00343880144940304
2,1371,121454.57156067,123,32,155,6,4.77379444419057e-06,0.00886330981174982
3,191,106423.24214026,124,78,202,7,1.99714258997119e-06,0.00978408798938851
4,241,40791.82182488,278,635,913,108,6.60654086459544e-06,0.0205085686873991
5,342,7677.4032092,2,2,4,1,4.3419504436315e-07,0.00276095963689505
6,196,68191.23047531,736,98,834,47,1.42966882776818e-06,0.00493926848422241
7,718,25553.31879329,59,70,129,23,2.63445099335513e-06,0.00723912014698986
8,710,4754.74716011,3,7,10,1,3.72291196981678e-07,0.00295578276468737
9,187,12074.80509254,106,8,114,4,6.05936747888336e-07,0.0031648805951346
10,167,21524.37177308,277,25,302,19,6.74149760016007e-07,0.00392174765507041
11,106,26259.18744137,73,18,91,3,1.55632915266324e-06,0.00486462667883305
12,101,5213.88782191,29,14,43,1,3.98454085370759e-06,0.00776723368145466
13,186,18791.06932752,230,6,236,4,7.10393123881659e-07,0.00343022401381552
14,177,24826.37831512,37,8,45,5,1.22986557471449e-06,0.00472229729987767
15,88,60952.22131313,278,295,573,160,5.16696673003025e-07,0.00396313647416313
16,433,14338.28187277,151,61,212,3,1.38076029543299e-06,0.0070350193952842
17,432,8225.85130509,96,23,119,13,2.20849869947415e-07,0.00228889703649992
18,428,10912.33971242,83,62,145,27,3.60344529326539e-07,0.00339277452286145
19,405,11927.36810527,16,21,37,9,2.95282916340511e-07,0.0026414197801052
20,333,11317.36247744,8,24,32,2,2.39912878896575e-07,0.00228768689914856
21,420,6110.87488905,71,5,76,13,7.22922777640633e-07,0.00368211549391952
22,329,16899.11611153,22,5,27,13,7.88438683230197e-07,0.00495345329409297
23,323,21600.67867353,38,23,61,18,7.25796326150885e-07,0.00481963106782358
24,317,7767.75147361,21,22,43,11,1.48497292684624e-07,0.00155241095040443
25,316,18011.82623663,60,23,83,27,5.72063527215505e-07,0.00305530478750935
26,233,39032.53424077,1419,413,1832,111,2.31820513363346e-06,0.00795954554198209
27,229,14950.02213444,68,94,162,20,1.61234720508219e-06,0.00599901790544492
28,228,102534.60336269,9,5,14,4,2.21710206460557e-06,0.00650560173476024
29,225,12915.42898558,40,0,40,1,2.16302532862755e-06,0.0100049290315931
30,216,64295.19897151,471,34,505,42,1.84188183993683e-06,0.00641718498760631
31,210,40873.30845099,450,104,554,34,7.13028839527396e-07,0.00349876725347277
32,208,6572.35138006,420,1,421,5,2.32335878536105e-07,0.00232563720445214
33,205,15486.32990799,28,16,44,16,5.94734046899248e-07,0.00381882686160986
34,204,71176.53470695,47,2,49,16,7.72253770264797e-07,0.00470966722020721
35,203,58733.38298363,500,16,516,8,6.77735897625098e-07,0.00428928010899359
36,820,13844.39339062,38,39,77,5,8.16247393231606e-07,0.00370436712867227
37,815,10863.40041288,18,7,25,4,4.38881215814035e-07,0.0031644731511508
38,814,17762.23499844,16,25,41,3,7.35880348656792e-07,0.00362927470156317
39,813,8774.12516026,11,4,15,1,4.44542365585221e-07,0.00272843464658359
40,669,11411.01565592,59,17,76,7,6.1847140386817e-07,0.00389746145700284
41,646,13380.10240163,25,5,30,6,2.88505680146045e-06,0.00867227585725811
42,627,15298.76089479,12,13,25,6,1.04065065897885e-06,0.00714480707626837
43,757,15182.75885458,7,0,7,2,1.03431739262305e-06,0.00717349678723288
44,303,31400.66444365,49,45,94,12,7.98198925622273e-07,0.00400826260618838
45,931,3957.17145366,24,3,27,2,5.96963673160644e-07,0.00327634622770689
46,828,18908.69637971,21,7,28,6,5.76326328882715e-07,0.00340923038079993
47,802,5116.5186923,84,0,84,3,2.30907971854322e-07,0.00193515627871271
48,800,17959.85652213,13,8,21,9,6.55266831017798e-07,0.0034377105555035
49,967,31098.00382649,7,5,12,4,3.48799585481174e-06,0.0081888727798409
50,951,29404.1381968,35,21,56,15,1.73759462995804e-06,0.00538084920650314
51,950,13531.18370009,3,14,17,2,1.3355424925976e-06,0.0047696563049621
52,924,17787.92517208,40,29,69,10,1.73788157553645e-06,0.00620313661319102
53,922,18971.22548794,7,0,7,1,1.92959078049171e-06,0.00712110283757686
54,913,31640.8786261,135,22,157,32,2.59310127148638e-06,0.0083801049504324
55,911,10825.40957705,54,80,134,20,1.18529851533822e-06,0.00470063546149651
56,491,12795.26883671,15,14,29,5,4.98860572406556e-07,0.00289567804020219
57,531,8924.97418277,69,17,86,13,8.09675839263946e-07,0.00368762096305961
58,533,3176.09706882,2,3,5,2,2.55169652518816e-07,0.00229774697668814
59,984,14395.83722267,54,91,145,1,1.05468870970071e-06,0.00469772257948264
60,982,36010.92866315,28,2,30,10,3.07438494928647e-06,0.00711691533409803
61,543,11505.40896679,56,4,60,8,9.66478182817809e-07,0.00505922105531387
62,549,4278.69226228,7,7,14,3,3.97580606659176e-07,0.00303886000642472
63,577,13975.37490701,173,84,257,4,6.28573161520762e-07,0.00317455016036414
64,578,25257.78909774,23,18,41,6,8.59461579238996e-07,0.00414971974950215
65,582,25070.55206813,412,36,448,69,6.68541815684875e-07,0.0034796066435183
66,585,5628.25217677,5,0,5,2,5.61874912818894e-07,0.00315495259290422
67,589,19280.09187642,130,13,143,23,1.63398954100558e-06,0.00593686180627963
68,594,6734.29111855,4,4,8,2,5.90058334637433e-07,0.00316212273775352
69,598,5766.36832382,5,0,5,1,5.79250809096266e-07,0.00306002493835436
70,600,5913.67186712,3,4,7,1,7.71258328313706e-07,0.00359651442228667
71,602,5708.8875334,0,10,10,2,8.54352492751786e-07,0.00370781732289784
72,617,7826.92801295,0,3,3,2,9.93712092167698e-07,0.00415491400623016
73,618,5498.06569648,3,0,3,1,5.87557224207558e-07,0.00303037710104952
74,619,4838.30956622,59,17,76,7,2.82542259810725e-07,0.00267452623493324
75,622,16193.4473931,30,9,39,1,1.01054001788725e-06,0.00404640462475735
76,623,1406.15413084,3,2,5,1,1.05303251984878e-06,0.00417489298464637
77,624,13725.90324963,13,5,18,5,1.45245076055289e-06,0.00531879895257395
78,628,82692.46773316,1813,152,1965,11,3.34818696501316e-06,0.00772908002569964
79,629,12161.63218908,53,6,59,13,7.18813225830672e-07,0.00368254216919189
80,630,10650.58621562,110,20,130,17,7.18264345778152e-07,0.00371398103814714
81,634,59530.38014948,7,0,7,4,1.91950448424905e-06,0.00561546641214188
82,637,22097.78476639,6,0,6,2,1.05713615994318e-06,0.00445320724786282
83,639,19071.73176265,205,57,262,20,8.44687292556046e-07,0.00413715951972883
84,642,15810.84506231,102,15,117,8,8.41169821796939e-07,0.00416085403930378
85,643,10495.32616244,13,3,16,4,4.14333499065833e-07,0.00263757961658324
86,660,11188.23734511,142,4,146,8,5.92473952565342e-07,0.0033385194961752
87,667,14769.38949066,32,16,48,8,9.16756562219234e-07,0.00527746125687274
88,672,4363.45677211,6,5,11,1,4.74255557492143e-07,0.0037596103347823
89,673,6040.81716416,1,10,11,1,7.21023297955981e-07,0.00451746977449506
90,680,724.34967199,1,2,3,1,1.58782313519623e-07,0.00200661143750965
91,683,6436.1994947,3,2,5,1,4.78295532957418e-07,0.00426351769412411
92,684,13962.05249981,47,26,73,17,1.0750477485999e-06,0.00483254066606683
93,685,5096.2160021,31,0,31,2,3.1324225346907e-07,0.00298739662662152
94,689,21517.36934667,0,1,1,1,1.56679288920714e-06,0.00566945651479544
95,850,2872.44581841,20,11,31,10,1.96576820599148e-07,0.00182931664232504
96,851,3251.55192044,0,2,2,1,2.66557435679715e-07,0.00206470681997716
97,857,5823.41582783,29,39,68,13,3.68525434168987e-07,0.00246419322326893
98,695,18919.26229056,58,18,76,20,6.76509898767108e-07,0.00360232072401347
99,697,15425.87654291,91,35,126,22,1.25278029372566e-06,0.00544803785978841
100,706,10061.17693134,40,7,47,3,1.25634460346191e-06,0.00459949572066298
101,714,5889.61768924,1,2,3,1,6.38871370028937e-07,0.00460249092759819
102,720,1882.25663036,3,5,8,2,3.45677108271047e-07,0.00231087538030432
103,729,9950.39250634,68,14,82,9,5.17882199346786e-07,0.00552429778492775
104,747,12468.51009832,15,9,24,9,1.14472686618683e-06,0.00581541046014469
105,752,13400.86859859,19,20,39,5,1.63492995852721e-06,0.00520709261132571
106,1001,98155.55672813,43,6,49,11,3.76881916963612e-06,0.00838840828158203
107,1004,9722.98662491,25,7,32,1,1.51347603605245e-06,0.00565245359960318
108,1005,15135.34479441,1,0,1,1,1.50664800457889e-06,0.00564273489357382
109,1013,12824.62836705,19,7,26,7,1.44684008773766e-06,0.0059539577920775
110,1014,18945.55866405,9,6,15,4,1.6289736777253e-06,0.00649466122854468
111,1020,7556.14544203,3,4,7,1,8.80528659763513e-07,0.00458430722547958
112,1023,11025.01977891,2,0,2,1,1.02816102298675e-06,0.00421522713578347
113,1027,5443.77217677,11,8,19,5,4.4308490032563e-07,0.00367677054611262
114,1046,60422.08205956,25,13,38,2,5.84197096031858e-06,0.0108618117272406
115,1050,18599.70321128,11,7,18,5,1.72461477632169e-06,0.0058981243517582
116,1051,17828.29016037,1,3,4,1,1.50315008795587e-06,0.00571496424066695
117,1053,6790.78681136,9,6,15,3,5.68917130294722e-07,0.00310891444618391
118,1056,5124.99016384,20,5,25,2,7.69177859183401e-07,0.00431851582777027
119,1057,24009.82532525,158,38,196,27,2.13495604839409e-06,0.00742110086752559
120,1058,9191.09857726,9,12,21,4,5.95496203459334e-07,0.00308348522310229
121,1062,54837.38202328,31,7,38,11,9.92885361483786e-07,0.004044628948051
122,1071,2420.31726428,8,1,9,4,2.68144503934309e-07,0.00221482961649812
123,1083,8227.08759976,85,13,98,12,8.61227363202488e-07,0.00408850957801642
124,1084,12228.18776104,59,15,74,11,1.02514286481892e-06,0.00478178765929937
125,1092,25362.22826207,191,27,218,17,4.067013378517e-06,0.00922796017626931
126,1096,36679.90741009,499,20,519,12,4.81503684568452e-06,0.00893988832514077
127,1103,9119.22460206,69,0,69,7,9.08145011635497e-07,0.00502354516577327
128,1109,4807.06766849,20,0,20,3,4.68326106783934e-07,0.00354297110998871
129,1116,11915.47356181,63,19,82,21,1.45132980833296e-06,0.00562992991252641
130,1133,7746.46125836,3,2,5,1,2.26983229367761e-06,0.00711005860674976
131,1135,10781.63123537,15,6,21,3,3.94485914512188e-06,0.00750902620806555
132,1137,5755.20391886,6,2,8,2,1.6362068890885e-06,0.00526295202533615
133,1160,19478.48182252,2,1,3,1,1.36350490720361e-06,0.00575959709336267
134,375,5436.26578369,26,0,26,3,5.62379682378378e-07,0.0030100408345942
135,376,8147.6096909,0,2,2,1,8.10176516097272e-07,0.00366327055793069
136,989,24501.06505108,1,2,3,1,2.51932897299412e-06,0.0068459006665507
137,389,34803.44260767,8,1,9,1,3.44116233463865e-06,0.00844897295152526
138,394,614.81450456,4,8,12,1,1.29373461277282e-05,0.0151526917139445
139,1201,582.41733546,3,1,4,1,4.01002125727246e-07,0.00274886101443864
140,1204,9932.03802086,3,0,3,1,5.89253431826364e-07,0.00307181637997713
141,975,9512.45418745,0,0,0,1,1.05789422377711e-06,0.00438128857952075
142,974,13071.4722457,5,7,12,1,1.15901775643579e-06,0.00451449782051033
143,973,9672.75755355,14,15,29,4,1.15201737571624e-06,0.00446880560660396
144,946,4706.93852212,37,3,40,4,4.28029125032481e-07,0.00266478957166552
145,945,6402.48287505,30,29,59,10,4.68573034595465e-07,0.00277113414569613
146,942,9428.98959104,170,32,202,5,7.91616002970841e-07,0.00445366105527597
147,908,5427.13944468,1,0,1,1,7.02325905876933e-07,0.00366831794281818
148,413,7244.90298235,11,39,50,7,1.86683791980613e-07,0.00217002116144049
149,302,52695.88807617,36,57,93,5,1.31548176796059e-06,0.00544491365659025
150,870,29877.52104833,273,315,588,8,4.62384559796192e-06,0.0127709848147885
151,398,73593.08064297,159,182,341,44,2.81206712315907e-06,0.0074840073487123
152,363,7491.5180391,40,8,48,12,2.52201471084845e-06,0.00749964732110147
153,1081,10435.47065806,9,1,10,4,1.01051591627765e-06,0.0044003477623634
154,1080,113781.62785453,113,10,123,30,5.51870061826776e-06,0.0102348659366069
155,1251,31882.43568105,9,25,34,4,1.41843338496983e-06,0.00518270739962536
156,1256,12628.89437277,3,2,5,2,1.8320424715057e-06,0.0060968106297028
157,1082,11147.56843109,87,16,103,6,1.56900568981655e-06,0.00578964481519045
158,1077,38542.44118236,70,13,83,5,9.64236278377939e-07,0.00417575312417726
159,1217,36566.59689432,15,0,15,4,7.70109181758016e-07,0.0035433336320133
160,1212,28160.38256035,14,0,14,4,1.01954083220335e-06,0.00404967502716801
161,1240,39642.39752769,27,10,37,6,1.7413181012671e-06,0.0054952818540495
162,1242,39088.64527397,5,0,5,1,2.54000678978628e-06,0.00726703156143102
163,1241,45772.45672914,23,25,48,10,1.43913939609774e-06,0.00527733155865805
164,1239,20438.844707,14,6,20,7,3.23942003888078e-07,0.00313336398964338
165,1236,1578.17654228,0,1,1,1,3.23597305396106e-07,0.00229302546739116
166,1237,18229.96013233,4,2,6,3,2.51479832513724e-07,0.00214512381317632
167,1324,20564.03898429,2,3,5,1,2.60050910583232e-07,0.00203134460896794
168,1321,30444.15449494,15,5,20,2,9.87532530416502e-07,0.00465197233164364
169,1322,103052.77871931,117,66,183,41,4.93322659167461e-07,0.00307610347145981
170,905,6240.03177981,33,1,34,2,1.06613333628047e-06,0.00506697372996563
171,538,9961.34880984,12,2,14,2,8.84091605257709e-07,0.00512099746490245
172,840,15983.50974403,16,27,43,7,4.95363110530889e-07,0.00376617572458493
173,841,10435.43444008,8,11,19,6,7.72271050664131e-07,0.00414010377529802
174,833,23019.15366119,121,49,170,8,1.40461679620785e-06,0.00625204014284116
175,132,36132.40590428,37,72,109,11,4.72713054477936e-07,0.00314280614085953
176,484,20542.62235338,733,20,753,36,4.53865141025744e-07,0.00306062456118075
177,487,6604.74485838,69,39,108,10,2.16225998883601e-07,0.00194666511057579
178,488,4499.50769551,32,0,32,4,1.35805294121383e-07,0.00161291897235039
179,489,12737.48714078,313,38,351,41,3.63315848517232e-07,0.00274543848104682
180,490,12471.31646885,149,7,156,12,2.74131252808729e-07,0.00239710434730553
181,485,8334.56410251,154,5,159,19,3.29466274706647e-07,0.00243621755743912
182,486,3365.09017681,24,0,24,1,1.01354089565575e-07,0.00143748627780621
183,483,10325.75249718,277,18,295,7,1.66727204486961e-07,0.00198219417393882
184,482,5865.08859665,164,28,192,6,1.84718828677433e-07,0.00180198810467806
185,521,20233.8545161,256,64,320,7,2.92134700430324e-07,0.00240437988365453
186,522,40111.90402908,71,64,135,10,3.74306182493456e-07,0.00346702134692956
187,494,14988.39068169,69,31,100,12,5.91724983678432e-07,0.00319372970788107
188,495,9396.84591272,172,0,172,4,4.52511812909506e-07,0.0026813552179783
189,496,19559.93879825,270,11,281,23,1.09304710349534e-06,0.00451207488057158
190,479,9248.79847465,221,124,345,21,7.96003405412193e-07,0.00353968589266767
191,493,16709.26929816,75,19,94,22,1.07113464764552e-06,0.00425971142774618
192,492,24745.73793287,289,23,312,21,6.09664311923552e-07,0.00312846717715337
193,470,35337.42085625,86,31,117,21,6.95784365234431e-07,0.00350356999955921
194,471,35231.547869,101,124,225,59,1.43280794873135e-06,0.00515791541709781
195,453,8456.26390212,163,22,185,33,2.37643689615652e-07,0.00229973501364387
196,454,57172.93849324,79,68,147,25,9.43877694226103e-07,0.00470314666852982
197,451,9277.89277968,243,46,289,29,6.06890353083145e-07,0.00310981072187756
198,445,18294.13147209,19,14,33,13,1.00795477919746e-06,0.00427590532001551
199,444,23166.68952608,68,6,74,6,5.46656792721478e-07,0.00347499457990249
200,446,22299.82132196,74,19,93,26,6.23115283815423e-07,0.00317213291343732
201,597,8533.85873528,61,76,137,26,1.35640220833011e-06,0.00508470284635146
202,544,20438.78606747,18,13,31,7,1.38990981213283e-06,0.00561554558869802
203,545,26647.65136267,184,76,260,52,1.69506847669254e-06,0.00630723547922777
204,586,20828.42532552,106,74,180,26,1.05954632090288e-06,0.00435803434407336
205,584,9756.8050127,1,0,1,1,7.56004283175571e-07,0.0035861428526384
206,551,5813.09928524,44,50,94,11,3.35942331730621e-07,0.00287952116056663
207,552,5580.0237084,15,21,36,3,6.4413598011015e-07,0.00338995872259653
208,553,56689.21917598,2,2,4,2,3.6892456591886e-06,0.00842470364293538
209,550,9861.48760455,62,62,124,14,1.07846926766797e-06,0.00418431173804791
210,554,6700.07582253,123,15,138,9,4.60293449577875e-07,0.0027137179431005
211,555,23752.94085638,77,63,140,13,7.6878222898813e-07,0.0036693039593565
212,556,19763.29357992,579,176,755,6,7.68571226217318e-07,0.00432432582252891
213,566,4303.23274847,52,22,74,8,2.66297320195008e-07,0.00245761750005003
214,557,3764.83731723,3,3,6,2,3.76766820409102e-07,0.00266070249625029
215,565,27394.88108767,647,118,765,67,3.90196873922832e-07,0.00261366636382413
216,564,57173.26905584,1482,334,1816,169,8.99777660379186e-07,0.00397675074554415
217,567,26119.60352696,315,52,367,41,7.7464574133046e-07,0.00365412993982724
218,571,10045.20677157,74,20,94,9,4.57184341939865e-07,0.00291679731185508
219,576,7772.97409783,0,16,16,3,2.51838173426222e-07,0.00224363090641728
220,574,19259.84737056,105,33,138,19,6.07067704549991e-07,0.003528344294109
221,570,22244.31229532,387,54,441,59,5.60206899535842e-07,0.00301169742213264
222,569,18477.49322381,460,12,472,20,4.21577169618104e-07,0.0026371352525458
223,563,6993.50677015,123,53,176,22,2.73934347205795e-07,0.0026239934580698
224,562,10205.26087861,155,22,177,10,2.13766725210007e-07,0.00202793590507555
225,561,22128.6614647,60,16,76,26,4.14698661188595e-07,0.00343650651125613
226,579,8240.66380685,19,56,75,14,6.63909304421395e-07,0.00352231239798516
227,581,5486.3555938,1,2,3,2,5.03847786603728e-07,0.00292705093891629
228,583,3783.24470825,10,5,15,2,3.37615347234532e-07,0.00234389811908404
229,1052,13150.54764555,18,6,24,5,9.15014879865339e-07,0.00422372401517801
230,1055,60112.87413789,17,5,22,6,1.48206572703202e-06,0.00487528045419183
231,1044,64537.21382274,6,9,15,3,1.72081581695238e-06,0.00538953204782961
232,1072,16496.28322492,100,21,121,3,8.02710928837769e-07,0.00399744863335222
233,1087,19427.75155977,269,20,289,12,1.80563574758708e-06,0.00593734668427222
234,1088,58812.29209148,148,27,175,24,3.58076613338199e-06,0.00811566649762591
235,1086,14387.10750196,30,17,47,7,1.21305993161513e-06,0.00511588078000577
236,1098,32191.43109014,73,4,77,9,3.58918941856246e-06,0.00880488201656851
237,1100,13696.91281007,22,3,25,5,1.2559298738779e-06,0.00497399759137517
238,1101,15160.84352239,123,21,144,28,1.44150590131176e-06,0.00544732353301544
239,1107,15430.81830965,0,2,2,1,1.21107859740732e-06,0.00477915065068508
240,1002,22860.37411343,10,7,17,6,2.20374931814149e-06,0.00635097786306829
241,723,9384.17986633,0,0,0,1,1.16204000732978e-06,0.00482173957776806
242,734,7907.78580186,1,0,1,1,9.958675946109e-07,0.00404601453242841
243,715,9556.96664905,19,7,26,5,1.06175230030203e-06,0.004511260516754
244,716,8978.39570047,5,5,10,1,1.15162492875243e-06,0.0046996396328481
245,826,16292.53380322,187,132,319,7,7.96436779637588e-07,0.00399055791645369
246,861,5377.99154114,43,28,71,15,5.00122041557916e-07,0.00297862411390817
247,860,19902.31837409,92,48,140,25,1.35147320179385e-06,0.00602823373801272
248,827,45407.95260069,260,75,335,10,2.84384259430226e-06,0.00870598478149589
249,859,7154.57816697,2,2,4,1,5.87084286962636e-07,0.00357141931717395
250,829,32435.47601146,28,27,55,15,1.90027230928536e-06,0.00712911243728086
251,837,28850.06398176,9,4,13,1,6.14431883150246e-07,0.00408132364503985
252,834,28220.35080782,11,16,27,6,1.07946470961906e-06,0.0057904279957096
253,843,15445.60820807,47,16,63,7,5.06847300130175e-07,0.00406332176509066
254,917,42440.65585958,201,14,215,18,1.53697919813567e-06,0.00766305768855579
255,918,12508.37707071,5,2,7,1,1.34902575155138e-06,0.00495038990691525
256,919,9674.01460774,70,35,105,15,8.41271685203537e-07,0.00388980517516505
257,920,15032.31270819,17,20,37,8,1.17270565169747e-06,0.00475368932583029
258,990,19385.76241887,4,12,16,3,1.94937911146553e-06,0.00663713448410835
259,938,3246.77511651,48,0,48,5,2.72445504378993e-07,0.00207899799335893
260,940,9303.09063711,3,0,3,1,6.97795258020051e-07,0.00345432660547953
261,935,10733.39036293,18,0,18,2,6.44499323243508e-07,0.0033594072294382
262,932,10770.19510846,67,0,67,4,7.65290224080672e-07,0.0041280858822762
263,937,8461.20152365,29,16,45,6,1.00713850770262e-06,0.00472517000318078
264,217,18742.26568585,254,151,405,29,1.14130989459227e-06,0.00452259643561169
265,220,8603.02096155,181,61,242,20,4.65113771497272e-07,0.00415230955272168
266,218,13362.98600213,94,0,94,2,9.43387931329198e-07,0.00488504029108074
267,209,54752.50029123,36,23,59,5,9.77976469584974e-07,0.00453520729852625
268,207,74315.93877835,27,13,40,9,1.58692728291499e-06,0.00553746391875947
269,213,5034.51921383,87,12,99,8,2.53361122304341e-07,0.00239486826820898
270,212,83216.14217599,2474,263,2737,40,1.55122143041808e-06,0.00500915595052096
271,231,34468.67374851,39,18,57,10,1.26586974147358e-06,0.00502842697288493
272,414,77997.20360037,83,38,121,21,2.28548651648453e-06,0.00783186111292314
273,961,7139.49798816,2,18,20,1,4.73844920634292e-07,0.00320294102368519
274,901,92245.53298005,500,557,1057,176,2.21869140659692e-06,0.00712211726580083
275,904,16995.97926233,31,12,43,6,1.13136002255487e-06,0.00544290585082079
276,184,78692.75437983,1023,177,1200,54,1.53828932525357e-06,0.00498147562063965
277,823,14400.20666113,60,26,86,8,3.65127561963163e-07,0.00283603082460723
278,811,10716.64970059,114,56,170,14,4.63436208519852e-07,0.00311596864279227
279,822,9985.95911171,29,34,63,4,8.509737199347e-07,0.00393434774815462
280,816,2009.56728588,51,9,60,5,1.86458237294573e-07,0.00221259873924845
281,806,13978.5509031,16,3,19,3,5.11854977958137e-07,0.0030279222789681
282,807,7895.42134995,14,0,14,6,3.41774921253091e-07,0.00244720377990101
283,809,12655.97676286,50,23,73,10,4.240891939844e-07,0.00303325971688279
284,796,6117.15229502,10,12,22,2,3.92817582905991e-07,0.0030402306613155
285,795,8052.14780306,45,4,49,3,3.23071617458481e-07,0.0027801922586759
286,801,11724.30604815,209,36,245,11,4.1037674236577e-07,0.00302222584621368
287,799,4803.5376634,10,3,13,4,3.84470240533119e-07,0.00302496503394505
288,797,16933.83333675,84,4,88,4,6.17998921370599e-07,0.00354022043798748
289,670,5227.80006822,186,33,219,13,3.67861503036693e-07,0.003358280276246
290,818,3106.3466681,3,2,5,1,2.83539066003868e-07,0.00276633909208952
291,798,8514.8107067,5,2,7,3,5.07312961417483e-07,0.00300406358201015
292,674,9901.53975832,6,5,11,1,8.34043930808548e-07,0.00516866726252229
293,810,10197.82241466,89,37,126,10,1.16732189781033e-06,0.00433429693216168
294,1323,14508.0011573,33,26,59,6,2.66806637228001e-07,0.00319397036664452
295,176,21281.3564785,142,29,171,12,1.41784175866633e-06,0.0049183987479789
296,174,48336.29629445,26,0,26,13,1.18283014671761e-06,0.00455852673400329
297,195,11801.99474891,56,13,69,7,1.26068471217877e-06,0.00471005547564704
298,226,265518.11832186,1323,39,1362,22,6.694880539726e-06,0.0112936282610603
299,237,41894.95637965,197,73,270,31,1.31108026835136e-06,0.00526104636754748
300,165,146828.46460996,2042,726,2768,19,2.33908485824941e-06,0.00713428312522382
301,164,142623.11425586,431,228,659,39,1.64423227033694e-06,0.00578512449953813
302,153,61194.44265666,849,121,970,68,1.09670554593322e-06,0.00468620395164453
303,158,37262.64314356,2000,150,2150,3,2.69059000856942e-07,0.00261843869375337
304,144,36338.70428257,426,153,579,72,6.97711129760137e-07,0.00385285696574536
305,147,40749.12079742,1757,28,1785,24,6.09885319136083e-07,0.00341713587443792
306,145,215408.94017735,823,161,984,160,1.26201712191687e-06,0.00447438457964553
307,142,29643.79498041,74,26,100,15,3.45916305377614e-07,0.00238690821276769
308,140,138812.01449651,2216,175,2391,81,1.12383850137121e-06,0.00515825313249528
309,127,141058.10038687,2832,395,3227,189,1.11462213681079e-06,0.00431174445041595
310,128,61697.0918299,878,61,939,3,5.71362761547789e-07,0.00345681146781987
311,129,94747.78428598,231,62,293,38,8.26105406304123e-07,0.00391419595733498
312,130,157205.80325993,3011,210,3221,30,1.05887556856032e-06,0.00436485431386121
313,131,62381.51059085,191,40,231,25,4.76992227049777e-07,0.00315249231102479
314,125,119185.24363898,2664,209,2873,54,9.10136350285029e-07,0.0049395567569349
315,124,176784.26453113,4025,292,4317,164,1.55350517161423e-06,0.00553114384943805
316,123,31624.99617409,447,70,517,93,1.10020982901915e-06,0.00431246387121799
317,122,53896.99045722,42,46,88,16,3.39776306645945e-07,0.0029128030659036
318,121,86953.77802534,1975,18,1993,60,7.35984031052794e-07,0.00350035191246861
319,116,230002.43081471,1197,335,1532,174,1.65051824296825e-06,0.00557085430679307
320,115,163560.57905104,327,37,364,73,1.4919564819138e-06,0.00537826658762239
321,114,112881.6768971,420,31,451,53,9.34918261918938e-07,0.00473030357783324
322,119,54184.32322702,586,370,956,135,7.47656031307997e-07,0.00369373269020016
323,120,127462.99009259,614,264,878,239,1.37377446662867e-06,0.0047457931402558
324,139,32336.78013785,323,212,535,102,8.37696006783517e-07,0.00437771876748195
325,138,13208.46159977,410,189,599,125,3.69017016055295e-07,0.00237200489565738
326,137,37144.28157121,709,381,1090,161,5.62824425287545e-07,0.00311428973900226
327,135,7920.41737744,136,55,191,41,1.18782281788299e-07,0.00149220884073628
328,136,35115.16028684,249,221,470,37,7.07404979038984e-07,0.00372321839847436
329,133,12737.7863113,81,20,101,2,2.58289219345897e-07,0.00267012888501859
330,166,26986.35075577,405,5,410,7,5.83991095481906e-07,0.00308560759373217
331,178,26433.45841855,42,6,48,9,1.27802286442602e-06,0.00471344408370721
332,98,97313.06939291,2442,212,2654,105,5.29177668795455e-07,0.00317882144731104
333,97,122505.31387824,1502,321,1823,143,9.5443328973488e-07,0.00391806212789389
334,96,129788.52341484,2258,414,2672,176,9.81551238510292e-07,0.00394809373061518
335,91,162778.32007298,1950,482,2432,256,1.12191219159286e-06,0.00558733589304825
336,90,262508.29884252,8041,963,9004,328,2.10265079658711e-06,0.00632303417970945
337,89,311129.64830437,9773,697,10470,200,2.00320573640056e-06,0.00603603416990629
338,87,88095.78220511,2927,213,3140,225,9.72832822299097e-07,0.00454678256331274
339,86,70896.64268825,699,177,876,79,7.48096226743655e-07,0.00418765177458794
340,85,130862.47000074,2429,206,2635,98,1.29579802887747e-06,0.00484009135496599
341,80,92923.77778767,1665,561,2226,155,7.15117948857369e-07,0.00377030652075884
342,94,68533.04396987,1013,217,1230,72,8.95470748218941e-07,0.00377759442812909
343,93,30458.67730152,147,89,236,11,4.9925756684388e-07,0.00305001222993892
344,74,69293.10257057,1552,415,1967,184,9.37012828217121e-07,0.00499188236061051
345,384,4352.22736619,16,2,18,6,6.53926690574735e-07,0.00361104606657599
346,383,15928.03069287,67,13,80,15,1.41312921186909e-06,0.00505668985776991
347,382,22425.45131203,4,0,4,1,1.36143717099912e-06,0.00859666425362275
348,372,4365.35860592,4,0,4,2,4.48284026788315e-07,0.0039879576051569
349,373,25832.71898796,206,16,222,17,1.67672169482103e-06,0.00635386647292414
350,385,31173.5648943,9,1,10,1,2.70069313046406e-06,0.00792105829659064
351,505,7801.4311673,8,12,20,2,4.76293735118816e-07,0.00334078033635055
352,504,7978.56582541,2,6,8,1,6.40110556560103e-07,0.00386372594333796
353,503,19501.51905029,17,9,26,6,1.32080867842888e-06,0.00473477814883085
354,500,10647.56141169,9,16,25,3,6.80314769851975e-07,0.00379723673434147
355,573,22645.50079687,57,16,73,14,6.41152837488335e-07,0.00318662802087773
356,838,14043.12291742,18,18,36,7,8.10951405583182e-07,0.00391807578127216
357,836,17985.79490092,44,12,56,3,8.47561295813648e-07,0.00476127598554955
358,844,112412.09017111,199,80,279,10,4.28672865382396e-06,0.00927074180683526
359,952,29530.56279225,351,64,415,12,2.16381067730254e-06,0.0060490711046455
360,912,7470.76400721,33,23,56,9,9.71099780144868e-07,0.00410489738838962
361,902,80962.00184864,132,75,207,30,1.07204732557875e-06,0.00585293659037365
362,903,28909.81733525,50,29,79,6,1.84195960173383e-06,0.00618739947316477
363,185,33095.72758392,474,43,517,9,9.85947735898662e-07,0.00397335595703376
364,188,20014.16071838,190,0,190,5,1.93481719179545e-06,0.00550772044313464
365,175,88990.45989094,665,99,764,185,1.42419048643205e-06,0.00493090393226807
366,192,60356.95702601,52,18,70,18,1.42485259857494e-06,0.00491606530524277
367,172,16448.20667519,63,43,106,13,1.26592522065039e-06,0.00469116404077097
368,170,49950.13081289,65,8,73,2,1.16272576633492e-06,0.0045118642703115
369,206,112095.20030725,440,1,441,35,1.23369682114571e-06,0.00466752494103643
370,193,26294.87953651,13,6,19,9,1.20802951641963e-06,0.00486322484740937
371,171,7825.49772888,33,5,38,6,5.16991804033751e-07,0.00349127175674982
372,151,15523.35025875,164,65,229,54,2.07238826988032e-07,0.00191069491916389
373,150,5500.62390722,28,15,43,10,1.54535428009694e-07,0.00216881684636427
374,163,70785.49174522,928,155,1083,25,5.45749117009109e-07,0.00304640982909826
375,1,26894.51858407,46,33,79,13,1.80413189809769e-06,0.00828757547455248
376,2,15642.81519541,167,18,185,7,2.57835517913918e-06,0.00715971349268137
377,4,14087.10546427,7,5,12,2,9.66444531513844e-07,0.00532091685043186
378,5,72385.35198327,1200,161,1361,29,1.38024051921093e-06,0.00687002680893016
379,6,10332.95756407,291,25,316,7,2.250999386888e-07,0.00186820986709807
380,7,7224.09204416,10,10,20,1,7.63698153605219e-07,0.00462474947692875
381,8,4242.99562524,131,0,131,1,3.87896307074698e-07,0.0027863452039789
382,9,26707.18038261,99,45,144,13,1.43516263051424e-06,0.00614014349108021
383,10,52682.14443673,96,46,142,23,6.07179572398309e-06,0.0115484132320643
384,11,272419.72172617,5888,558,6446,141,2.32566981139826e-06,0.00886572766443429
385,12,20495.08708627,458,129,587,25,2.65599692284013e-06,0.0106114188720468
386,152,16202.00776011,237,127,364,45,3.21230800182093e-07,0.00231307155259359
387,214,10727.37959299,73,23,96,11,3.41493432642892e-07,0.00255394865250152
388,219,28300.59613019,481,173,654,82,1.32767445393256e-06,0.00587948299183948
389,215,318741.76882701,2444,1820,4264,47,3.72434396922472e-06,0.00810620675304521
390,230,33008.09453056,49,82,131,16,2.00963449970004e-06,0.00589857655096478
391,501,3936.32034364,4,6,10,3,2.8731028578477e-07,0.00254568644544443
392,502,22083.02440246,168,24,192,8,8.26660652819555e-07,0.00362488241142466
393,507,21138.38108702,70,32,102,10,9.43911800277419e-07,0.00487486519802342
394,508,21256.54758358,124,72,196,12,9.22435447137104e-07,0.00403347373508454
395,509,8861.5589929,180,19,199,32,7.10183030605549e-07,0.00367449207239151
396,510,19159.78266245,130,15,145,17,1.42316594065051e-06,0.00491378362767951
397,511,5623.93033599,73,42,115,12,4.26280621468322e-07,0.00320144566118693
398,512,28165.68111224,138,71,209,11,6.04877641308121e-07,0.00330087345490141
399,513,12247.43550831,52,33,85,6,7.87243607192067e-07,0.00359636377950959
400,514,22368.13216246,203,41,244,33,8.39183485368267e-07,0.00370970417132355
401,515,21833.27283264,37,54,91,9,8.44356691231951e-07,0.00518029768660012
402,516,19321.11252429,215,65,280,31,8.30500539450441e-07,0.00412846813423381
403,517,21414.08972768,358,102,460,35,8.45845534058753e-07,0.0041272769235964
404,518,31108.71416,642,377,1019,66,8.71958945936058e-07,0.00422248343481679
405,523,76532.99819024,3293,548,3841,47,1.28553710965207e-06,0.00467478768983328
406,524,72481.49964132,1383,389,1772,147,1.47840000863653e-06,0.00632216329739688
407,525,11307.24997689,128,25,153,30,5.33130787516711e-07,0.00328713306146643
408,526,13113.72039992,83,59,142,19,1.03127786132973e-06,0.00408129949763924
409,527,2909.87652769,56,6,62,1,5.46846877114149e-07,0.00302898451106716
410,528,11294.09454717,165,47,212,23,8.85653207660653e-07,0.00459469695754749
411,529,14185.59341377,330,48,378,39,5.0089374781237e-07,0.00281558149212645
412,530,55837.17494267,824,127,951,71,1.53683822645689e-06,0.00502790459192671
413,532,8615.97392576,160,51,211,12,4.90606453240616e-07,0.00290129873249448
414,534,13943.62076819,63,22,85,6,1.08550739241764e-06,0.00491026870708045
415,537,14011.19180918,177,36,213,8,1.10697283162153e-06,0.00474239140382887
416,540,11939.37942402,53,1,54,1,2.03481067728717e-06,0.00598864421686455
417,541,5439.12756555,22,1,23,1,6.99733391229529e-07,0.00468909155658931
418,542,13121.86858064,14,14,28,4,9.43935447139665e-07,0.00498393608183944
419,546,17089.12733129,250,32,282,14,1.3767639757134e-06,0.00495567435682265
420,547,15121.35491056,31,7,38,5,7.25062363926554e-07,0.00433263063076421
421,548,8796.69344801,32,10,42,3,6.16616034676554e-07,0.00415571012813582
422,558,36001.61999677,483,4,487,1,5.83094333705958e-07,0.00314316636330716
423,560,6715.92490338,35,35,70,9,1.8925720723928e-07,0.00178191464859828
424,568,4358.84025127,95,84,179,20,1.40504198498093e-07,0.00152892899302345
425,572,23983.97228547,177,32,209,5,6.53699771646643e-07,0.00325893420444774
426,575,21137.35421089,178,79,257,26,6.80487119097961e-07,0.00332308784221223
427,587,14594.33655167,47,46,93,22,1.24035113913124e-06,0.00701700288668154
428,590,129605.47403097,32,14,46,10,4.65528592030751e-06,0.00848360871843123
429,591,8600.01100957,7,1,8,1,6.67269432597095e-07,0.00346033813318888
430,596,28263.20600706,167,51,218,28,2.83454801319749e-06,0.0067583139209528
431,605,9879.78350114,13,2,15,3,1.05920162241091e-06,0.00419021283563429
432,14,10076.2204878,78,34,112,8,5.49255673831794e-07,0.00406091274451381
433,15,17914.27640392,178,62,240,47,8.2360065789544e-07,0.00371585148866504
434,16,32904.4815294,826,45,871,34,1.38868290378014e-06,0.0056532430767737
435,17,13737.78531482,40,40,80,7,1.15901048047817e-06,0.00487060380473911
436,18,35215.22716457,307,78,385,34,8.65707079356071e-07,0.00485466810255061
437,19,19016.01535852,101,67,168,42,7.47542344470276e-07,0.0038243517604409
438,20,29682.99491102,249,111,360,52,3.40270662491093e-06,0.0188832904313034
439,79,66264.14616765,205,343,548,6,3.73491093341727e-06,0.0106832825621911
440,21,128436.10630629,264,180,444,37,1.71487636180245e-06,0.00811818353514288
441,22,61959.26284652,373,149,522,6,4.47862930741394e-07,0.0029292474883908
442,23,72412.33473002,260,56,316,37,2.4600967662991e-07,0.00239105035571592
443,24,44225.15544864,120,11,131,10,5.89484898227965e-07,0.00383411024003281
444,26,142977.86470761,5450,76,5526,76,7.57429006625898e-07,0.00382207642363776
445,27,71674.83820417,690,221,911,50,1.00189390650485e-06,0.00461922147538073
446,28,229854.61317224,6461,181,6642,221,2.25692656385945e-06,0.00600223414594644
447,29,187515.60699594,4232,414,4646,193,1.95773418454337e-06,0.00571111343155138
448,30,52699.02477993,628,329,957,91,7.30393821868347e-07,0.00401393380844179
449,31,131444.70891202,4006,283,4289,48,7.98865130491322e-07,0.00391779293295445
450,32,73316.39624803,644,131,775,15,8.52587163535645e-07,0.00385630850799363
451,33,25599.01127804,944,145,1089,40,3.88532498618588e-07,0.00245665077036136
452,34,146654.08408457,4072,91,4163,72,1.39398480314412e-06,0.00503357607849491
453,35,117294.54331855,2375,364,2739,61,9.63542788667837e-07,0.0040241296928812
454,36,50844.16784554,1940,314,2254,225,3.49519723386038e-07,0.00258040636441017
455,37,15507.86618185,260,108,368,1,3.23494077747455e-07,0.00228301043556016
456,38,16970.1716795,703,6,709,3,2.69013071374502e-07,0.00205753528721915
457,39,157096.7496209,5616,368,5984,103,7.23626271792455e-07,0.00352279150406656
458,40,194993.29784612,5097,145,5242,248,1.44911791721825e-06,0.00533666303632839
459,41,142587.95249623,4396,348,4744,109,9.21403625397943e-07,0.00390225866276032
460,42,99016.08354391,1949,449,2398,87,7.82932602305664e-07,0.00390154155715934
461,43,147987.84488355,5003,276,5279,298,1.10396968011628e-06,0.00491479835154093
462,44,132561.21942226,2697,364,3061,158,8.29000782687217e-07,0.00446775881509052
463,45,116668.91724092,4496,469,4965,134,9.09397385839839e-07,0.00386864588068775
464,46,143927.7258025,3767,402,4169,156,9.54788447415922e-07,0.00439602377187761
465,47,46291.92825241,390,33,423,25,3.11039457301376e-07,0.00232062522029774
466,48,93941.56039251,3028,189,3217,92,7.14468114892952e-07,0.00485838466072107
467,49,143041.56727126,4650,146,4796,25,1.10125620267354e-06,0.00539328581572968
468,50,83119.29425282,2102,341,2443,51,6.65231254970422e-07,0.00375005255894797
469,606,16199.80789881,124,0,124,24,1.31274646264501e-06,0.00559012721343587
470,608,11718.28752822,147,5,152,11,8.10713618193404e-06,0.0134948990864295
471,781,68582.43218774,2478,35,2513,31,1.62079095389345e-06,0.00567440921783957
472,609,9382.62070199,56,16,72,9,1.71508418134181e-07,0.00232008477044272
473,610,19998.45065274,392,136,528,11,2.89453510049498e-07,0.00362860305216158
474,611,5556.23463661,30,21,51,8,4.11545897804899e-07,0.00348848800514142
475,614,49581.01438576,4,8,12,4,1.97880899577285e-06,0.00685966400389488
476,625,3231.14623231,12,8,20,2,4.5287547436601e-06,0.00875397981176356
477,626,44595.05818218,532,104,636,72,2.27053669732413e-06,0.00780877923126789
478,631,38802.12143196,559,124,683,4,1.32513332573581e-06,0.00571772653614743
479,632,18070.82711975,16,11,27,2,1.48401704791468e-06,0.00584282632052864
480,633,9975.08750631,5,0,5,1,9.19015747058438e-07,0.00386341635972512
481,638,16889.71329157,330,29,359,10,8.43722773424815e-07,0.0041623707292947
482,640,16498.06232516,4,1,5,2,1.46978618431604e-06,0.00546769690745038
483,641,22897.22088552,40,8,48,8,1.45172316479147e-06,0.00549480703528243
484,644,25738.16740028,372,71,443,24,1.16063620225759e-06,0.00503015376592753
485,645,32496.9515131,48,7,55,6,9.51334186538588e-07,0.00464785926733217
486,647,10198.47945471,130,44,174,35,7.55915607442148e-07,0.00380020456123818
487,648,61832.60770363,491,115,606,24,8.39660515339347e-07,0.00378567527329526
488,649,15496.45718714,113,43,156,32,7.63564912631409e-07,0.00387062240568806
489,652,47666.52066479,135,89,224,52,1.87234854820417e-06,0.00838576785937108
490,656,19986.25433189,117,72,189,30,1.33356888909475e-06,0.00526371961160309
491,657,20436.06267135,204,47,251,23,7.46548721508589e-07,0.0034179616090381
492,659,33855.25051694,8,4,12,4,1.16273395178723e-06,0.00502725166097375
493,661,20996.82123751,23,9,32,14,7.96505446487572e-07,0.00372505198212122
494,662,7906.75155011,67,22,89,5,5.73645138501888e-07,0.00308062960944099
495,666,3636.18245179,15,0,15,1,2.16863554669544e-07,0.0025467279597748
496,665,63098.26496522,69,12,81,15,1.08391704998212e-05,0.0214034636040955
497,675,13843.11838206,23,16,39,3,1.19314972835127e-06,0.00530499484940548
498,678,5466.80524674,9,2,11,2,4.88026671519037e-07,0.00310942508861397
499,679,10702.42936556,41,48,89,7,6.98611529514892e-07,0.00462292298272431
500,682,11944.72365836,0,2,2,1,9.9234375738888e-07,0.00463907872097696
501,686,13660.94202006,26,2,28,9,1.3096364455123e-06,0.0055331981941399
502,688,70476.2328303,341,230,571,5,3.51835888068308e-06,0.00785427204841906
503,690,11511.06830176,26,20,46,10,1.01775731309317e-06,0.00520138048331437
504,691,42686.04566972,54,27,81,15,2.59856960838079e-06,0.00801714566584213
505,692,7598.19635458,0,3,3,2,6.39055087958695e-07,0.0032239969593343
506,698,17844.95679431,31,63,94,19,1.25927226690692e-06,0.00487287308688034
507,699,22527.24038882,169,148,317,50,1.67142843565671e-06,0.00647542968224624
508,700,6362.13662564,41,38,79,13,1.98787347471807e-07,0.00209836058375755
509,703,5722.77091917,2,1,3,1,5.23121343576349e-07,0.00291799491112217
510,705,8529.8982879,2,0,2,1,9.56041276367614e-07,0.00395719922324744
511,707,15705.046494,9,2,11,2,1.2369487194519e-06,0.00453363962963547
512,708,14468.0909161,4,0,4,1,1.52089342009276e-06,0.00587121493059793
513,712,3575.46776502,0,1,1,1,4.08510913985083e-07,0.00318062136018972
514,713,11546.24077064,7,18,25,3,1.36414882945246e-06,0.00545541579634663
515,717,18609.33398794,156,123,279,46,8.01345777290408e-07,0.00443793754532694
516,719,13743.90424861,9,26,35,1,6.69871496938867e-07,0.00334575165174498
517,721,32951.10689517,168,101,269,38,4.72831970910192e-06,0.0104298691242668
518,727,8171.97148592,15,13,28,6,8.4451539805741e-07,0.00666254484929131
519,728,15296.45312263,2,8,10,2,1.85514272743603e-06,0.00666272463458818
520,730,6707.52892546,40,24,64,11,6.86127350491006e-07,0.00334925540578201
521,732,8861.06953238,18,8,26,5,6.40868620394031e-07,0.00568720543247226
522,739,4603.24559305,23,29,52,14,3.58370925823692e-07,0.00285763064614465
523,741,10267.12905839,8,7,15,7,6.0800630308222e-07,0.0032457709782268
524,748,14257.07880861,17,8,25,6,8.19122760731261e-07,0.00408153438918806
525,753,21174.03330646,20,24,44,4,1.59569708557683e-06,0.00562140930470974
526,754,23770.50988953,2,0,2,1,2.03456829694915e-06,0.0060836059992157
527,778,91140.91031825,1072,39,1111,30,1.8375052150077e-05,0.0231927558776828
528,779,38025.91104956,123,23,146,26,3.23372660204768e-07,0.00286251803378223
529,780,19248.64098399,58,11,69,11,3.03215074382024e-07,0.00274325628650309
530,782,4813.97507318,30,14,44,6,1.01188106782502e-07,0.00153133990836929
531,783,25214.83587948,230,28,258,4,3.37041456077714e-07,0.00260550931900517
532,784,18861.87526334,106,66,172,27,5.24666575074662e-07,0.00374054628492618
533,785,14352.39080605,159,32,191,5,2.10207417694619e-07,0.00196345681149356
534,787,14301.1556589,188,7,195,22,6.20887931290781e-07,0.00405754081969382
535,788,19046.80960424,378,31,409,33,8.33676949696383e-07,0.0040856453878629
536,789,12408.34185042,180,26,206,19,8.14201030152617e-07,0.00364628879904547
537,791,15506.597205,63,20,83,10,6.24866515863687e-07,0.00331559701760725
538,792,4514.73396962,34,28,62,9,3.33333900925936e-07,0.00232548635276144
539,793,4784.13925836,23,9,32,6,3.5632820072351e-07,0.0024820285811334
540,794,11816.19169973,47,36,83,8,4.63477135781432e-07,0.00287741195313294
541,803,3350.94787286,3,3,6,1,2.64089976553805e-07,0.00206532864666531
542,819,9212.25128164,68,26,94,8,6.2918252297095e-07,0.00328079265751407
543,821,31125.88515544,72,38,110,15,1.4814372661931e-06,0.00596284566347674
544,871,158947.19907925,1594,1051,2645,51,9.37026652536588e-06,0.018894734523324
545,831,15838.73785143,2,1,3,1,8.12991402199259e-07,0.00390573091962247
546,832,30350.2884756,166,106,272,6,9.47294211073313e-07,0.00437453185423511
547,845,144179.00971486,16,5,21,8,5.71078544453485e-06,0.011988018721905
548,849,5434.91231979,37,38,75,14,4.14479018218117e-07,0.00264228537700546
549,856,3535.06857077,2,0,2,1,3.02440639643464e-07,0.00217198515128359
550,858,9017.73844942,38,65,103,21,8.63535660755588e-07,0.00378658890425518
551,863,166281.74827968,2986,452,3438,96,1.35633081299602e-05,0.0180235780388561
552,915,22924.83421014,102,19,121,4,2.037906597252e-06,0.0112509722758905
553,916,17835.17156571,165,50,215,4,1.16599539978779e-06,0.00551435576866959
554,921,11355.78758916,1,6,7,4,1.01432124210987e-06,0.00537254609898994
555,925,19605.40107353,50,33,83,35,1.24802090795129e-06,0.00538256401201078
556,926,9362.8147093,6,0,6,1,1.05452227217029e-06,0.0048330435031935
557,939,9212.19991094,1,4,5,1,9.83563040790614e-07,0.00433596031938728
558,941,9131.16933567,20,2,22,5,6.94614755047951e-07,0.00352483617803427
559,947,9432.72198652,36,3,39,4,6.52701601211447e-07,0.00346176525001537
560,948,10515.62526215,82,25,107,24,7.17513557901839e-07,0.00357602645760366
561,949,17626.0137934,19,9,28,3,2.46357421929133e-06,0.00681415307381818
562,953,15498.54046807,31,16,47,5,1.90837135960464e-06,0.00624682286140307
563,958,25279.83673,148,34,182,48,2.59897933574393e-06,0.00649145714556142
564,959,31586.55142313,20,24,44,6,3.02187800116371e-06,0.0077825144967396
565,965,3778.3646463,26,6,32,5,2.19868979911553e-07,0.00204054415274873
566,976,35191.47074664,13,14,27,8,2.14776173379505e-06,0.00591106577660737
567,977,24017.11015756,25,31,56,20,2.17067781704827e-06,0.00693701544104352
568,979,2528.84994023,1,0,1,1,5.69258645555237e-07,0.00362256025212286
569,980,9275.52048657,49,8,57,5,3.01491354548489e-06,0.0074463754032326
570,992,30258.18095446,61,28,89,6,3.49032916346914e-06,0.0075463574462188
571,993,6462.67583889,4,3,7,1,9.63337515713647e-06,0.0156739633899159
572,995,5391.74317508,39,9,48,4,1.8560735952633e-06,0.00903705151472162
573,1003,169727.52824815,228,75,303,9,1.41332320708898e-05,0.0171610145576881
574,1006,16521.5556749,18,13,31,2,5.24446295457892e-06,0.0097424520687399
575,1008,16826.48874439,27,5,32,5,1.27610519484733e-06,0.00537112717294667
576,1011,26978.96488519,25,3,28,6,1.57838849190739e-06,0.00601634196807132
577,1012,14252.42808811,9,10,19,3,1.58148077389342e-06,0.00605755897051084
578,1015,21151.92423493,3,3,6,2,1.77775427800952e-06,0.00664022833784857
579,1016,30494.86999529,74,44,118,14,2.45498995354865e-06,0.00727120848446283
580,1017,2606.4287916,3,0,3,1,7.57113411964383e-07,0.0048668706606788
581,1018,10710.40943897,2,0,2,1,9.23669176700059e-07,0.00477637494262135
582,1019,10914.11273446,10,0,10,1,1.00346460385481e-06,0.00530932027645536
583,1024,18504.1852341,17,3,20,4,1.46084812513436e-06,0.00832699189797628
584,1025,11840.41593641,13,2,15,5,1.0002554517996e-06,0.00500928400645267
585,1028,7868.62962807,11,0,11,1,8.01863279775716e-07,0.00421942823325931
586,1029,10544.37182873,3,2,5,1,9.90319676930085e-07,0.00532189885150996
587,1030,71668.50085284,183,45,228,31,6.88776026436244e-06,0.0122407799875091
588,1031,20161.55292407,8,10,18,4,8.69126324687386e-07,0.00384168369509965
589,1032,14299.20198498,25,10,35,6,9.15927557798568e-07,0.0040027240955732
590,1034,13120.20496112,21,0,21,2,1.24106418297742e-06,0.00512927706861575
591,1035,12162.01321044,42,29,71,8,1.23763902593055e-06,0.00510908932785378
592,1036,12385.26789643,3,8,11,2,1.22450501294225e-06,0.00511625058170252
593,1037,25419.37128555,136,41,177,22,1.48065055327606e-06,0.00569534844142966
594,1038,25223.77198413,89,14,103,16,2.17968317883788e-06,0.00749714041952976
595,1039,14148.59515906,45,32,77,11,8.4593602878158e-07,0.00391729157799133
596,1041,8201.90200176,59,19,78,5,5.7246643336839e-07,0.00326233261238796
597,1040,18165.07008849,32,11,43,4,1.53081919052056e-06,0.0048976606686521
598,1043,30193.64634746,229,58,287,28,1.89764841707074e-06,0.00559053904855318
599,1045,642.33040338,0,28,28,1,2.02362025447655e-06,0.00633308790051713
600,1049,19103.59655481,16,2,18,5,1.62967762662447e-06,0.00724148472991578
601,1164,12337.89254751,26,30,56,3,1.16276396511239e-06,0.00518275876637147
602,1059,59599.93744567,365,157,522,41,2.61492687059217e-06,0.00792250558788575
603,1060,97852.65816331,55,50,105,19,1.53997916640947e-06,0.00648856158244802
604,1061,48965.20330179,200,48,248,38,5.37073537998367e-06,0.010205568982968
605,1063,32993.01635996,8,4,12,4,1.2544401215564e-06,0.00442966676348003
606,1064,136399.96380973,60,30,90,25,3.03621709463187e-06,0.00798137643200816
607,1065,86964.60117087,186,42,228,22,2.21598384086974e-06,0.00644315707387943
608,1066,9391.29352492,12,9,21,7,4.95132098876638e-07,0.00317970446875319
609,1067,30860.64514704,402,40,442,17,5.7579304666433e-06,0.0108123422824252
610,1069,7806.88492982,106,24,130,12,1.06710876934812e-06,0.00516291302377416
611,1070,37499.75669492,205,6,211,9,1.29502313939156e-06,0.00537053855800195
612,1073,35643.46019609,6,1,7,1,6.83541657053865e-07,0.00333712776086802
613,1074,12629.247239,3,0,3,1,5.60779426450608e-07,0.00307187906302007
614,1075,47412.97394537,8,5,13,4,6.91933564667124e-07,0.0034454006453765
615,1076,147259.2252551,381,259,640,58,2.27679129238823e-06,0.00612985985100251
616,1078,87996.20303026,341,5,346,19,1.53404280354152e-05,0.0176567403211569
617,1218,99087.37084588,13,4,17,1,2.07080438485718e-06,0.00568345601391403
618,1216,38018.83236353,1,4,5,1,7.79204583523097e-07,0.00383095686814797
619,1089,67402.62049,31,26,57,15,1.98795669348328e-06,0.00614339712508582
620,1090,124496.96019626,1141,190,1331,86,1.29113768707612e-05,0.0151393850581659
621,1091,42170.1818185,67,12,79,16,1.77143010660075e-06,0.00534845954408389
622,1093,61622.43985888,523,78,601,63,7.27056294635986e-06,0.0130163047516903
623,1094,74763.26966892,291,75,366,24,9.39506344366237e-06,0.0141749955518289
624,1095,107330.01248027,1045,111,1156,159,1.11471872514812e-05,0.0149588621566674
625,1097,63954.69464168,510,156,666,21,7.51692004996585e-06,0.0122072693976697
626,1099,7146.78188939,21,1,22,2,1.23804920804105e-06,0.00479855899794237
627,1102,27090.66112121,261,26,287,31,2.04848447538097e-06,0.00626418332117182
628,1104,18690.33292587,50,2,52,9,1.35878235596465e-06,0.00523978726702711
629,1105,10647.55782472,16,6,22,6,1.26356053442578e-06,0.00496028585512916
630,1106,18024.26415729,157,19,176,25,1.31988235807512e-06,0.00508410872985977
631,1108,13983.87750202,74,2,76,7,1.27978591990541e-06,0.00476440701255047
632,1110,28311.25226148,379,5,384,25,2.85002442979021e-06,0.00698015321406191
633,1111,22408.93828238,201,5,206,15,1.55075849761488e-06,0.00530361731422489
634,1112,21080.39400946,145,6,151,10,1.51610902321409e-06,0.00527190950458201
635,1113,44277.04104233,3,8,11,3,1.63122740559629e-06,0.00560817940924187
636,1114,18874.71014169,34,11,45,4,1.73539365277975e-06,0.00572706508949879
637,1115,8195.91678042,36,1,37,8,1.54941426444566e-06,0.00564658622654075
638,1117,45563.63983529,64,13,77,13,2.24230916501256e-06,0.00598969919572104
639,1118,35291.67414778,856,89,945,59,1.18689422379248e-06,0.00442579942097939
640,1120,21154.62785515,64,2,66,6,2.17326714846422e-06,0.00635674165917566
641,1121,16732.02381377,392,3,395,6,2.17299248106428e-06,0.00636156668327174
642,1122,104760.96303016,115,40,155,10,7.51308880353463e-06,0.0111860789227065
643,1123,67044.87322475,179,62,241,10,4.35990659752861e-06,0.0109942486010787
644,1214,125358.62152248,13,17,30,7,6.89826856614673e-06,0.0108487543688971
645,1126,1641.57818189,0,4,4,1,9.48934939515311e-07,0.00387206453571433
646,1127,6785.39346524,9,7,16,6,1.63594222613028e-06,0.00525847649452221
647,1132,17448.47458669,5,0,5,2,5.44441991223721e-06,0.0188659059032424
648,1139,15088.87211997,107,36,143,19,1.44878640639945e-06,0.00502891447335327
649,1140,39573.71802955,262,48,310,43,2.7890246201423e-06,0.00663527476214413
650,1141,54608.58959339,257,46,303,26,4.09029416914564e-06,0.00867187480140516
651,1143,31165.97241368,471,50,521,58,1.82228268386098e-06,0.00606005369775613
652,1144,84.88885802,0,2,2,1,2.11791211768286e-06,0.0062847354246211
653,1148,20265.10626967,205,19,224,33,3.80919937015278e-06,0.00816232219293902
654,1149,39888.78540072,101,46,147,25,2.46918625634862e-06,0.0100315841216728
655,1150,54930.51118046,41,19,60,10,3.34046308125835e-06,0.00903166585581573
656,1151,25826.08705039,89,37,126,14,1.92955531019834e-06,0.00587220778712174
657,1152,97658.47417298,902,126,1028,70,1.15833900053985e-05,0.0161486488044592
658,1154,101669.87149495,594,121,715,71,7.80736445449293e-06,0.0141465730616735
659,1153,95111.00214913,990,149,1139,101,9.83700147116906e-06,0.0137821626993673
660,1155,239480.12749166,1726,224,1950,134,2.37984891100496e-05,0.0201665512101765
661,1156,145149.73482254,1107,73,1180,143,1.25574269986828e-05,0.0149986644781779
662,1157,214954.61404424,1457,316,1773,127,3.43343640452076e-05,0.0394378006277587
663,1158,72144.83618343,615,439,1054,56,2.12451532206615e-05,0.037799072229618
664,1159,95699.15075827,638,87,725,46,1.19650721899234e-05,0.0202742272071667
665,1161,40344.29115252,27,3,30,6,4.32901319982193e-05,0.0272197059529717
666,1163,35128.13821483,191,7,198,9,2.69493152700306e-05,0.0280496855533526
667,1208,34148.45185966,14,1,15,3,4.89852482132846e-07,0.00319518567356864
668,1209,35624.86201268,17,2,19,5,6.61064404994249e-07,0.00363591939253604
669,1213,72270.27568999,16,0,16,3,6.50815172775765e-06,0.0107627397260238
670,1325,105593.25344606,51,12,63,11,1.9965582396253e-06,0.0060467799497122
671,1345,12991.57308922,59,126,185,18,2.06515824174858e-06,0.00843126104370853
672,51,81419.80257255,3129,227,3356,141,7.52396317693638e-07,0.00382421969896326
673,839,23224.00161693,213,40,253,30,7.65880031394772e-07,0.00378850978183175
674,835,17510.14362812,97,38,135,11,9.30037003854522e-07,0.00511989029990675
675,687,9193.09559925,25,6,31,2,7.41693838790525e-07,0.00584749471049697
676,746,9532.25453355,4,5,9,2,9.60230863711331e-07,0.00412250223622215
677,740,15130.60410709,31,17,48,11,7.55752807890531e-07,0.00429878042560952
678,52,23327.20647563,48,28,76,7,6.68960183247691e-07,0.00425417433844859
679,53,110929.64278746,2929,183,3112,118,1.21355787996436e-06,0.00494478705992238
680,54,249026.20929208,8079,661,8740,508,1.9881167645508e-06,0.00570530420981358
681,55,240182.24726928,5681,663,6344,404,1.76007824848057e-06,0.00530767165870371
682,56,40829.15436006,2079,185,2264,3,5.86688202020014e-07,0.00338281868235502
683,57,87098.69652484,2676,402,3078,47,5.00715941598173e-07,0.00316950148521183
684,58,95739.49331164,3693,244,3937,169,8.98079633770976e-07,0.00385722466668811
685,59,149191.14398122,1799,136,1935,22,4.81162351206876e-06,0.0120977561036875
686,60,18357.54400631,234,40,274,11,6.0473848861875e-07,0.00421576027239693
687,61,177748.86130044,5051,519,5570,133,1.43410989039694e-06,0.00518720567793461
688,62,57714.3086844,2066,72,2138,94,8.93805008672643e-07,0.0046756777743835
689,63,46063.36150308,1552,101,1653,110,4.86530552734621e-07,0.00285205370061716
690,64,45190.54357295,2010,31,2041,46,4.52210315415869e-07,0.00291330012703209
691,65,34346.57306394,954,161,1115,102,4.65879566036165e-07,0.00278728279553967
692,66,102160.43072027,3571,318,3889,83,7.10927906766301e-07,0.00336013772505763
693,67,206017.86303401,6104,1286,7390,67,1.57884232976357e-06,0.0050459264745741
694,68,182663.27083756,6429,388,6817,180,1.66400513990084e-06,0.00517549821926326
695,69,87203.08433223,2076,429,2505,112,7.3010824053199e-07,0.00389118730495922
696,70,70373.44385673,1078,177,1255,53,5.88974671700271e-07,0.00381895454254747
697,71,134365.63943163,3298,168,3466,109,1.15641296360991e-06,0.00456709868296232
698,72,69384.88025214,445,0,445,3,1.13240366772516e-06,0.00471235230047389
699,73,227248.80232236,4085,223,4308,80,1.56971418618923e-06,0.00549178851275199
700,75,138337.21672077,3461,440,3901,214,1.08710946733481e-06,0.00495587820687057
701,76,102171.60446395,3337,553,3890,255,1.12206316771335e-06,0.00496996988437666
702,830,148064.21255119,829,143,972,12,7.81630751589546e-06,0.0113197834153328
703,77,286225.78571178,5915,1142,7057,362,1.96314113054541e-06,0.00574382707152899
704,78,269321.35932299,7170,749,7919,341,1.77645188159659e-06,0.00542652081084178
705,81,8449.69478342,38,2,40,4,7.13855570211308e-07,0.00416356071478267
706,82,17742.58312986,80,199,279,7,2.29852139455033e-06,0.00732163509122284
707,83,203196.13745428,8355,1060,9415,39,4.19634852732997e-06,0.00882189952164513
708,84,6592.275833,0,10,10,1,2.37481344811386e-07,0.00208331759730771
709,95,112589.45814603,1679,387,2066,52,1.94457697944017e-06,0.00545182938373764
710,100,30340.78234478,135,52,187,4,1.53933342517121e-06,0.00598412003531862
711,102,881.21211485,17,0,17,2,7.64680316933664e-06,0.0115032966533987
712,103,27075.33478508,280,40,320,23,4.59965885966085e-05,0.0545376099811559
713,104,68333.68844863,265,80,345,3,8.55527514431742e-06,0.0126216064883414
714,105,7272.09513779,10,1,11,3,8.50358765092096e-06,0.0111195115027239
715,108,16923.66672004,27,42,69,4,3.17315880238311e-06,0.00796361891264598
716,109,6447.54345314,14,6,20,4,7.46734212953015e-06,0.0106773924063107
717,110,27962.57936922,185,129,314,4,3.14803264700458e-06,0.0153413208680081
718,111,104043.08756269,679,57,736,41,4.66218898509396e-06,0.029111071563466
719,424,38420.54298943,275,39,314,19,1.69602981259231e-06,0.00955378311691743
720,400,14398.97276166,9,2,11,2,1.01876457847538e-06,0.00719492485596023
721,419,8506.8446847,5,10,15,1,7.10952008375898e-07,0.00345375675119985
722,417,22081.51284839,25,15,40,8,2.02809860638808e-06,0.0105513256314614
723,416,41098.71623797,439,18,457,63,1.53248993228772e-06,0.00651387761735087
724,415,25706.83553853,63,8,71,8,1.43890702020144e-06,0.00563151291540389
725,411,41925.11524342,35,48,83,8,5.7329716582899e-06,0.0103569550124246
726,408,90389.72604137,11,12,23,9,3.22666255669901e-06,0.00837497439349569
727,407,130211.3139703,319,167,486,19,3.98974316340173e-06,0.0106606286009296
728,404,24456.7066507,85,51,136,19,6.28186171525158e-07,0.0031608418984005
729,406,34548.73800671,45,21,66,13,1.125681137637e-06,0.00461250575917793
730,402,18871.07190725,92,52,144,19,6.29958321951563e-07,0.0034203323256457
731,403,27425.49280403,177,102,279,51,9.82036908681039e-07,0.00542249922388345
732,401,85461.62614085,172,150,322,43,1.37316101245233e-06,0.00530284831094514
733,393,4835.79542142,18,3,21,3,2.29454267355322e-05,0.0208257151633445
734,392,5194.53475506,38,21,59,7,4.24790714532719e-05,0.0270633347020942
735,391,25571.95609531,147,34,181,2,1.69320787790639e-05,0.0202533406111322
736,381,16580.27437317,5,1,6,3,1.45008334584418e-06,0.00579875255256448
737,371,21512.80334888,52,6,58,9,1.43759234561003e-06,0.00593547306450309
738,370,50606.52511418,432,52,484,35,1.34674892251496e-05,0.0160367841085303
739,360,97812.46063249,533,42,575,19,1.45981234709325e-05,0.0182018283132912
740,362,142101.99929919,469,135,604,84,1.26701238514215e-05,0.0173344626194479
741,361,64160.37644009,755,8,763,45,1.28879319163389e-05,0.0237235407200061
742,357,43289.1715849,621,64,685,45,3.92553829442477e-07,0.00253002275135478
743,355,7176.64072158,13,11,24,6,3.2293246476911e-07,0.00234431516583659
744,352,17596.98763623,26,9,35,7,2.4960036171251e-07,0.00242065874588372
745,353,3170.27890799,28,21,49,9,1.44498244480928e-07,0.00178680236146365
746,351,26372.32919623,126,8,134,13,1.23136987895123e-06,0.00516307190466742
747,350,73998.22502126,1139,93,1232,71,1.1761321729864e-06,0.00479034353820495
748,349,12418.15811316,60,4,64,4,1.13090845843544e-06,0.00474352275383533
749,348,2984.00531573,37,10,47,5,2.5222698241123e-07,0.00201077699941644
750,347,1554.52386687,16,7,23,2,3.2435355024063e-07,0.002406898573759
751,344,4640.36313576,4,5,9,1,1.99944679479813e-07,0.00213496357396517
752,343,6621.21206266,23,24,47,7,5.11857706442242e-07,0.0030465160699886
753,340,10193.67851255,26,6,32,8,1.19407422971562e-06,0.00443400080593157
754,339,49979.50435196,949,108,1057,57,1.61006346388604e-06,0.00532446899896023
755,338,33281.3561118,484,15,499,5,1.77139190782327e-06,0.0055290253985791
756,331,7465.5113635,32,2,34,2,7.67114670452429e-07,0.00567173867764346
757,330,10940.12612286,13,0,13,2,2.60601154877804e-07,0.00228336728652324
758,337,26713.78446942,210,11,221,4,2.73894465863123e-06,0.00754730804640827
759,336,7567.30537572,45,51,96,10,5.00229816680076e-07,0.00300561306110766
760,335,7496.34590504,0,3,3,1,1.76172306964872e-07,0.00192390446597956
761,332,25403.33903333,3,1,4,2,1.06604193206294e-06,0.00562605380193775
762,327,10324.80297513,28,10,38,8,1.57510839926545e-07,0.00173664372992964
763,326,44889.51799631,108,63,171,23,1.53106293510064e-06,0.00659627921600911
764,325,75968.08575766,11,1,12,5,1.70797466125805e-06,0.00721163453066237
765,324,36810.95034368,55,150,205,32,5.54861344426172e-07,0.00475482984698393
766,322,21001.92407858,18,1,19,8,4.84393240185454e-07,0.00343586657482771
767,321,15661.43414913,181,80,261,53,3.09558345179539e-07,0.00225855172950226
768,320,39345.54450531,84,73,157,49,8.26241830509389e-07,0.00512900194213428
769,318,18152.63595203,24,22,46,7,5.44486738363048e-07,0.00323362765689992
770,315,132076.24536888,219,97,316,36,3.93541677112808e-06,0.00930398407917589
771,314,21213.05119328,22,18,40,6,6.90945398673648e-07,0.00515742612869589
772,305,99513.06790182,230,66,296,47,2.85074111161521e-06,0.00834668201104086
773,306,47780.22861861,12,0,12,5,1.28994543047156e-06,0.00500314437532124
774,307,100605.18104471,1042,13,1055,18,2.29787656280678e-06,0.00701936968446923
775,308,98364.54585497,979,286,1265,12,2.49618997258949e-05,0.0325202451748881
776,304,51553.02730411,2,2,4,1,1.93008509086212e-06,0.00730851555628279
777,301,104393.84235887,15,7,22,5,7.05823731550481e-06,0.0111915717665067
778,300,82063.64793216,139,128,267,11,7.60533202992519e-06,0.0326566944871539
779,499,26919.78187822,455,162,617,51,1.24652842714568e-06,0.00446723347399353
780,498,18201.40549606,133,36,169,25,1.62004653248005e-06,0.00519575016432538
781,497,35399.50603611,227,14,241,8,1.6138674254762e-06,0.00578749880957931
782,481,16685.80452225,66,4,70,4,2.4198789105867e-07,0.00199942120911831
783,480,40227.49335855,703,0,703,2,2.27631380766979e-06,0.00673451638040326
784,478,76317.22961418,165,25,190,18,2.39934479395743e-06,0.0063935885810904
785,477,33692.18801019,119,26,145,37,1.54606186697492e-06,0.00511750299654751
786,476,11816.67638368,47,4,51,5,5.2333689382067e-07,0.00387185459277034
787,475,9928.50857267,27,2,29,5,8.29141299618641e-07,0.00391526492500701
788,474,22570.92761575,55,53,108,14,1.54245481098769e-06,0.00549009469846719
789,473,18477.48444162,106,91,197,44,1.02427338788402e-06,0.0047889685451906
790,472,16121.57126618,40,14,54,21,4.90669208375039e-07,0.00325259834900373
791,469,30886.21733581,111,113,224,42,7.56847384764114e-07,0.00361807166391964
792,468,69256.62702923,98,46,144,27,8.14522536529694e-07,0.00363214757482005
793,467,63589.40578424,430,64,494,38,6.24650965619367e-07,0.00324098067187253
794,466,43397.51162073,99,82,181,33,6.52183189231437e-07,0.0032809815703376
795,465,73179.90171834,1848,317,2165,51,8.46535840537399e-07,0.00465049689744519
796,464,67744.73655432,396,64,460,18,6.54261384624988e-07,0.00315053231875334
797,463,7909.1902014,15,11,26,5,4.69137376057915e-07,0.00281204115541286
798,462,9458.43923915,18,7,25,6,6.26756445853971e-07,0.00316997518506298
799,461,10950.92264471,18,5,23,2,2.90927346213721e-07,0.00224381389100852
800,460,33346.13414333,4,2,6,2,6.32336195849348e-07,0.00384748210497576
801,459,63124.81908226,328,44,372,13,2.22313656195183e-06,0.00590273557406266
802,458,22954.27115831,500,93,593,37,9.9427734312485e-07,0.00410449094016255
803,457,37374.18207069,431,120,551,42,1.00117267720634e-06,0.00418341907369366
804,456,18151.38253754,163,74,237,33,1.00630859378725e-06,0.00422130359320089
805,455,17255.8897812,250,32,282,17,6.31015154795023e-07,0.00316966953547322
806,452,16882.49753237,215,33,248,39,5.86487658438273e-07,0.0031201845376821
807,450,17156.48715957,63,10,73,8,9.64815626502968e-07,0.00414305143758214
808,449,19151.4686098,247,36,283,14,9.54730694502359e-07,0.00411690202034637
809,448,8774.11984475,21,14,35,7,9.17921624932205e-07,0.00404791763987185
810,447,12472.1066776,34,11,45,8,9.54396455199458e-07,0.00408128805317268
811,442,33248.85844689,143,52,195,10,2.18543527807924e-06,0.00660084301327032
812,441,8314.77838187,45,3,48,16,3.90556124330033e-07,0.00266697265877414
813,440,61018.8444955,59,20,79,12,1.27966177387862e-06,0.00581859695137021
814,439,13610.25581522,57,34,91,22,3.890518200933e-07,0.00257964838955222
815,438,64010.25045319,7,5,12,5,3.21440666084527e-06,0.00775066383609675
816,437,16513.71003735,27,37,64,10,4.71497969556367e-07,0.00294947231701998
817,436,18783.0530343,51,15,66,9,8.52502125781029e-07,0.00370307575767683
818,434,24565.97953902,158,120,278,21,2.81892380371573e-06,0.00683774203493127
819,431,8464.22208848,36,18,54,13,4.78880338050658e-07,0.00281762590394281
820,430,26296.65296795,95,101,196,24,1.10072869574651e-06,0.00582554359645745
821,429,64661.18273865,43,9,52,10,7.70693986851256e-07,0.00515602054039335
822,427,18283.47966906,21,20,41,3,1.29574800666887e-06,0.00518955105065197
823,423,51901.11439531,1112,17,1129,6,8.27877556730527e-07,0.00371204239938393
824,422,151484.29578579,1059,157,1216,6,2.57282181337359e-06,0.00789243244862187
825,421,4482.71910671,63,4,67,3,3.42080966220237e-07,0.00267315131774864
826,113,250997.82918633,6419,709,7128,81,4.87771058033104e-06,0.0109027540594834
827,118,44050.56343141,78,106,184,40,3.66237600246677e-07,0.00305017147797848
828,126,408100.13821736,6966,1211,8177,255,1.87973819265608e-06,0.00548163128091705
829,141,23193.97950663,3,0,3,1,4.8235961003229e-07,0.00313661251461636
830,148,141855.65906197,266,1205,1471,99,1.42673479786026e-06,0.00516948112664663
831,149,11495.67496508,119,76,195,15,2.85071109829005e-07,0.00239285606234299
832,154,11249.69724161,115,77,192,30,2.70819782599574e-07,0.00255906560317616
833,155,25873.31657887,44,12,56,5,2.7597843654803e-07,0.00259041397019591
834,156,74906.85778669,4017,81,4098,26,5.77234914089786e-07,0.00313716598791747
835,157,678.30551039,7,0,7,1,2.4382175070059e-06,0.00631950742697644
836,159,22705.92622895,106,155,261,32,5.32641024619807e-07,0.00335741784482371
837,235,12565.65359379,4,5,9,3,4.10534084949177e-07,0.00325961427454933
838,240,58.35298446,1,2,3,1,4.24590552938753e-06,0.0145332015950435
839,234,118444.52453209,5193,479,5672,17,5.78844355914043e-06,0.0113017760418384
840,239,52228.54344401,376,20,396,9,3.99534292228054e-06,0.012355216660554
841,238,101634.90432208,407,810,1217,19,3.48024968843674e-06,0.014332327218364
842,232,55101.55453368,9,15,24,4,2.12225404538913e-06,0.0068039822150638
843,223,24690.45361052,281,216,497,37,4.47053344032611e-06,0.0126995528730011
844,211,31182.76039147,41,32,73,15,5.01680460729403e-07,0.00296954364987583
845,190,2470.42187944,22,1,23,2,1.44823297887342e-06,0.00962599361244328
846,189,19443.25031203,71,64,135,6,1.28578540170565e-05,0.0156941847112061
847,183,142916.49643565,1342,274,1616,100,3.49641959473956e-06,0.00775099677395127
848,182,84881.32505117,769,251,1020,10,9.01083240023581e-07,0.00384293008681424
849,181,103374.96505571,1720,161,1881,15,2.69652309725643e-06,0.00673387865628435
850,180,30424.67676487,267,194,461,5,1.40530119097093e-06,0.00488146494421038
851,179,75268.23785447,1332,791,2123,12,2.71667931883712e-06,0.00665212561253808
852,169,46853.89516663,102,165,267,9,1.13956184577546e-06,0.00449162692887473
853,168,48260.01922972,223,60,283,2,2.3932766453072e-06,0.00848563991616672
854,162,32910.7706802,452,1,453,4,1.12423867903999e-06,0.00489965421820485
855,651,9623.10561228,41,22,63,8,8.6437830759678e-07,0.00390620193934779
856,650,20858.90456183,95,42,137,5,2.23088318307418e-06,0.00814924154280984
857,198,27527.58250317,2,5,7,1,1.29070440380019e-06,0.00489429397051191
858,201,35545.15073605,8,0,8,1,1.41163081934792e-06,0.00550776579708855
859,346,6226.86126089,11,2,13,2,1.8316313799005e-07,0.00171455252013766
860,345,1740.58643844,25,0,25,1,3.64942479791353e-07,0.00264496118454755
861,868,42444.03725043,69,35,104,6,2.2745506157662e-05,0.0398416097943747
862,1301,463109.94906663,15099,1406,16505,129,4.41106794824009e-06,0.00870687816753073
863,1304,23261.75056092,44,0,44,2,9.25554832065245e-06,0.0225373726663607
864,173,25513.7579954,121,89,210,9,1.26984423332033e-06,0.0047080339461448
865,824,1965.28140041,4,14,18,1,8.9323125394003e-06,0.0123167533184821
866,890,118957.29666558,3113,165,3278,9,4.20261449107784e-06,0.00867573947581863
867,884,85242.98185087,413,467,880,26,1.06659040284285e-05,0.0145637755227758
868,882,19799.66625366,41,5,46,6,3.97854500988615e-06,0.00891483288336956
869,886,22721.13342832,152,132,284,23,4.62918615085073e-06,0.0162674617965639
870,880,119025.77057969,779,719,1498,12,6.97560653861729e-06,0.0139255254791913
871,885,78651.76967981,963,1022,1985,22,8.60213276610011e-06,0.0138426280837621
872,881,67350.31769985,485,970,1455,5,1.09450575109804e-05,0.013403108501928
873,883,24127.50693926,126,166,292,10,6.39052404949325e-06,0.0120830149387849
874,1231,57249.75925281,28,15,43,9,1.48278195410967e-06,0.00780635644383043
875,354,48927.21912198,172,77,249,27,1.55589077621698e-06,0.0050051942626464
876,161,127063.28904889,5984,348,6332,19,4.06528761232039e-06,0.0119748031395664
877,1370,132944.92249038,317,45,362,2,4.33059267379576e-06,0.00940627087659317
878,1372,61659.80456502,137,10,147,2,2.38436359722982e-06,0.00640900915491611
879,1255,10038.90490384,68,2,70,13,3.12930751533713e-06,0.00882576485201262
880,1373,51151.14328709,2665,171,2836,2,1.0845660654013e-06,0.00445483531539278
881,588,13289.07251911,0,0,0,0,1.29120144265471e-06,0.00553629974469634
882,711,6125.14025672,0,0,0,0,2.04370962819667e-06,0.00914033860089544
883,756,9011.6765236,0,0,0,0,7.45939814805752e-07,0.00598246748194703
884,435,6219.61204842,0,0,0,0,2.93474840873387e-07,0.00243683157701065
885,409,9254.73444107,0,0,0,0,2.62927642324939e-07,0.00207902903302907
886,341,6369.50979378,0,0,0,0,6.66767391521716e-07,0.00329228787844799
887,418,3927.0036507,0,0,0,0,3.51520156982588e-07,0.00276936582592264
888,328,6693.1427855,0,0,0,0,3.55397332896246e-07,0.00268686219238488
889,319,4538.95748192,0,0,0,0,1.8871878637583e-07,0.00174860562664753
890,313,31371.7309238,0,0,0,0,1.21452467283234e-06,0.00638876030535602
891,227,8442.06590241,0,0,0,0,8.09390257927589e-07,0.00476558681294238
892,200,6751.61003415,0,0,0,0,3.84601662517525e-07,0.00282307442825902
893,199,8975.04983549,0,0,0,0,5.85263023822336e-07,0.00377973789581688
894,930,10823.53822502,0,0,0,0,5.28889813722344e-07,0.00291368380752046
895,805,9009.43673075,0,0,0,0,2.63089987129206e-07,0.00224810805450906
896,804,17910.1623583,0,0,0,0,3.28043370245723e-07,0.00261575610114172
897,986,6315.23328915,0,0,0,0,6.8618601289927e-07,0.00482999890016192
898,964,16000.05341198,0,0,0,0,1.23915197036695e-06,0.00509406192090132
899,934,7518.87494349,0,0,0,0,6.66806045046542e-07,0.00340173641621735
900,927,8731.15107814,0,0,0,0,1.01260275187087e-06,0.00443019258345436
901,910,7186.85118,0,0,0,0,8.60294221638469e-07,0.00428184219794517
902,909,5227.26449499,0,0,0,0,8.64281446411042e-07,0.00415676700480869
903,535,9345.37537329,0,0,0,0,7.96058429841651e-07,0.00376392344302889
904,985,2614.77563494,0,0,0,0,2.23924416786758e-07,0.00215814064272038
905,981,11861.28370489,0,0,0,0,1.32189325086074e-06,0.00513672149589223
906,593,4516.40647538,0,0,0,0,6.50345555186505e-07,0.00333613135237162
907,592,5732.71781072,0,0,0,0,6.23602772975573e-07,0.00323232598425697
908,599,8593.01317932,0,0,0,0,6.81699020788074e-07,0.00335298625304491
909,601,7714.7479994,0,0,0,0,9.50692992773838e-07,0.00392236736471886
910,603,4824.56725854,0,0,0,0,7.26653524907306e-07,0.00341436033553596
911,612,6541.42463829,0,0,0,0,6.30439899396151e-07,0.00321325147038656
912,616,33093.29640446,0,0,0,0,9.02176907402463e-07,0.0038972439732822
913,621,11464.02875429,0,0,0,0,1.28963574752561e-06,0.00486951650074085
914,635,36076.33588071,0,0,0,0,1.45150670505245e-06,0.00497123849636527
915,655,8502.88337141,0,0,0,0,1.01523801276926e-06,0.00479423933902868
916,668,1791.63016454,0,0,0,0,3.66616404789966e-07,0.00345623033601242
917,681,7472.35992881,0,0,0,0,6.17879322817316e-07,0.00353945652141915
918,709,2760.42542209,0,0,0,0,3.70197994925547e-07,0.00250827886114067
919,724,10849.19064759,0,0,0,0,1.19060632641776e-06,0.00484366088001791
920,744,7233.18508391,0,0,0,0,4.99560428579571e-07,0.00328986794566355
921,1021,3414.89905974,0,0,0,0,4.77212779514957e-07,0.00339556163479223
922,1022,14220.08447919,0,0,0,0,1.13039232019219e-06,0.00437587089383823
923,1033,378.07389683,0,0,0,0,3.98848669647123e-06,0.00843434162187183
924,1047,9775.1165663,0,0,0,0,6.4987125369953e-07,0.00340845605609293
925,1054,14735.75921541,0,0,0,0,6.24182575847954e-07,0.00322973250715348
926,1134,6104.8471376,0,0,0,0,1.96620658243774e-06,0.00659893367524101
927,1136,5849.70358444,0,0,0,0,1.63895629157196e-06,0.00526237107738692
928,1138,4655.46305355,0,0,0,0,1.35268737722072e-06,0.00491616214080941
929,1142,17350.68826452,0,0,0,0,1.96042401512386e-06,0.00620706656655426
930,374,2865.75479363,0,0,0,0,2.43519480136456e-07,0.00206276946828397
931,991,8962.09171878,0,0,0,0,1.94080121218576e-06,0.00685379906791494
932,988,4387.20572885,0,0,0,0,8.48769559524953e-07,0.00365414845259522
933,380,4068.01318452,0,0,0,0,3.15790202876087e-07,0.00230898462928163
934,386,20917.65907593,0,0,0,0,2.17932711166213e-06,0.00593591123374034
935,388,46900.86991407,0,0,0,0,3.94431344830082e-06,0.00828320674219934
936,395,17087.70635174,0,0,0,0,3.17297144647455e-06,0.00787108651614342
937,396,10139.36848426,0,0,0,0,1.53646988110268e-06,0.00511216921937093
938,1202,10641.78100678,0,0,0,0,4.99841917189769e-07,0.00292138248991062
939,1205,17662.51731496,0,0,0,0,6.42713985143928e-07,0.00344687136132096
940,1206,16700.75739016,0,0,0,0,6.3444076658925e-07,0.00334053350896084
941,1207,105.66561155,0,0,0,0,1.26505665321019e-06,0.00530340206668985
942,978,11249.20309347,0,0,0,0,1.08414997157524e-06,0.0063952484632871
943,972,7859.07923468,0,0,0,0,1.01555315268342e-06,0.00427261790238491
944,969,7855.67539236,0,0,0,0,1.05415529105812e-06,0.00432885883959866
945,906,3189.8839678,0,0,0,0,4.2308329284424e-07,0.00255113558535212
946,390,1336.16752942,0,0,0,0,2.13877578971733e-05,0.0236267624997015
947,1257,2678.88127984,0,0,0,0,8.27243184176041e-07,0.00375824372473134
948,1252,1632.95472379,0,0,0,0,7.51253992348211e-07,0.00378561318787442
949,1222,17520.31320478,1,0,1,0,4.06530489271972e-07,0.0025941691522759
950,1211,31352.29578173,1,0,1,0,6.99762040312635e-07,0.00374511360173036
951,1341,13096.9708936,0,0,0,0,6.16504621575587e-07,0.00348643573199872
952,1342,44841.22996136,0,0,0,0,9.09072696231306e-07,0.0041419494245678
953,1349,780.58454621,0,0,0,0,1.49819697981002e-07,0.00155622186347434
954,615,10151.58975645,0,0,0,0,9.46187810768606e-07,0.0040001471534761
955,853,2579.66344804,0,0,0,0,3.04210061585763e-07,0.00221701879936997
956,846,4856.29146394,0,0,0,0,6.73859176458791e-07,0.0034743749992142
957,847,3215.47593292,0,0,0,0,3.00683495879639e-07,0.00218797423574443
958,852,2515.55052814,0,0,0,0,2.68368694378296e-07,0.00207998575785304
959,855,3008.63658913,0,0,0,0,3.44459749612724e-07,0.00234523561161726
960,519,4128.54505511,0,0,0,0,3.04248715110589e-07,0.00244470949925329
961,607,6717.78268875,0,0,0,0,5.45503098692279e-07,0.00359776552066326
962,1000,39783.49670391,0,0,0,0,2.27880946113146e-06,0.00712197421838779
963,745,4060.46297449,0,0,0,0,6.42580289422767e-07,0.00328977612761861
964,725,3448.15797721,0,0,0,0,4.19204297941178e-07,0.00259830085294988
965,944,7451.99281869,0,0,0,0,7.46002569940174e-07,0.0035799137073673
966,943,8329.00095878,0,0,0,0,7.13741428626236e-07,0.00345246672734763
967,960,31198.96760743,0,0,0,0,2.48742117037182e-06,0.00674391477279044
968,970,6593.12836822,0,0,0,0,9.14573774934979e-07,0.00401812187405817
969,933,9488.37555236,0,0,0,0,9.25081621971913e-07,0.00425005503638511
970,425,4373.52048732,0,0,0,0,3.36724951921497e-07,0.00293736994166713
971,399,4700.82618274,0,0,0,0,3.43183273798786e-07,0.00320017448648249
972,954,7942.78255311,0,0,0,0,1.34536367113469e-06,0.00476309577469927
973,956,27179.27785659,0,0,0,0,2.90050320472801e-06,0.00784941506980895
974,812,14851.8251611,0,0,0,0,5.26593794347718e-07,0.00291978290761655
975,817,7867.06276194,0,0,0,0,5.66961261938559e-07,0.00309341790377649
976,194,6916.46185468,0,0,0,0,5.09997789777117e-07,0.00346369645684755
977,378,3151.83435489,0,0,0,0,3.25501787301619e-07,0.00274497471031964
978,379,19913.31059502,0,0,0,0,1.7098464013543e-06,0.00587331540215451
979,387,21736.62909818,0,0,0,0,1.26066561279004e-06,0.00563942589974463
980,520,9480.18069741,0,0,0,0,6.38875462755095e-07,0.00384265798960603
981,842,19873.95893069,0,0,0,0,7.29919520381372e-07,0.00414884642563337
982,914,7888.51518793,0,0,0,0,1.01772411653656e-06,0.00500760939766443
983,536,7192.44205361,0,0,0,0,5.38728272658773e-07,0.00374563363207954
984,539,35167.5827407,0,0,0,0,1.85152657650178e-06,0.00591353601969124
985,580,16633.11981839,0,0,0,0,9.02296505955746e-07,0.00389237514862377
986,595,12723.23429961,0,0,0,0,1.24092639453011e-06,0.00465059984945622
987,604,5639.1916245,0,0,0,0,4.35707534052199e-07,0.00272289465088936
988,13,4713.30800953,0,0,0,0,2.43321210291469e-07,0.00284990160488726
989,790,8482.96744288,0,0,0,0,3.17509147862438e-07,0.00334825905466186
990,613,12467.76157789,0,0,0,0,8.60913587530376e-07,0.00383250434654404
991,620,8295.50716714,0,0,0,0,7.61694082029862e-07,0.00359549234679357
992,636,36370.28266487,0,0,0,0,2.18022705666954e-06,0.00588138384179694
993,653,28790.06719205,0,0,0,0,1.47361197377904e-06,0.00487863229579986
994,654,8917.43384956,0,0,0,0,9.41106463869801e-07,0.00430859405842466
995,658,4823.71201117,0,0,0,0,3.2987327358569e-07,0.0023317707999911
996,664,18836.63186414,0,0,0,0,4.25910911872052e-07,0.00263537516380145
997,671,780.7202391,0,0,0,0,6.57597411191091e-07,0.00353526431304406
998,676,8338.97312237,0,0,0,0,8.53764959174441e-07,0.00411704883981859
999,677,3570.66475705,0,0,0,0,2.94779965770431e-07,0.0025272784879693
1000,693,2776.95532235,0,0,0,0,7.80913069320377e-07,0.0048116451724214
1001,694,9000.93432682,0,0,0,0,5.2194172894815e-07,0.00361165758246391
1002,696,10410.12444276,0,0,0,0,1.05004119177465e-06,0.0044477404265742
1003,701,5375.1134882,0,0,0,0,4.40120402345201e-07,0.00321287438724345
1004,702,5833.09462746,0,0,0,0,4.96032498631394e-07,0.00283512833913031
1005,704,4126.45527608,0,0,0,0,4.00266799260862e-07,0.00352026988567972
1006,722,10851.9097557,0,0,0,0,1.4409870345844e-06,0.00489682151100585
1007,726,2909.88820676,0,0,0,0,4.29046394856414e-07,0.00263381069737213
1008,731,10370.02385957,0,0,0,0,1.02734657048131e-06,0.00420852929236155
1009,733,3831.67520593,0,0,0,0,3.00307874567807e-07,0.00309214252243717
1010,735,5857.36834639,0,0,0,0,8.26261384645477e-07,0.00368519500023411
1011,736,13896.45068359,0,0,0,0,1.66630115927546e-06,0.00574482384498869
1012,737,10343.53703803,1,2,3,0,1.34671154228272e-06,0.00533928826141508
1013,738,6025.43398539,0,0,0,0,7.52455889596604e-07,0.00371001853508522
1014,742,4769.62342128,0,0,0,0,6.55709754937561e-07,0.00337020573237165
1015,743,3183.17301144,0,0,0,0,4.07966581406072e-07,0.00255758396648712
1016,751,4408.72454148,0,0,0,0,6.29489022685448e-07,0.00336406249980968
1017,755,8504.79434995,0,0,0,0,6.71725956635783e-07,0.00524101819624458
1018,758,2623.19067134,0,0,0,0,1.85475983016659e-07,0.00190270115620764
1019,759,1259.70440115,0,0,0,0,9.87056409940124e-08,0.00125894405734562
1020,760,1708.28562439,0,0,0,0,1.38844370667357e-07,0.0015443092303452
1021,761,1367.14005636,0,0,0,0,1.4392435332411e-07,0.00186637382402697
1022,848,2885.15350903,0,0,0,0,2.94349774776492e-07,0.00218091762729063
1023,854,5413.247575,0,0,0,0,5.78469553147443e-07,0.00336673031274381
1024,869,29698.43880724,0,0,0,0,3.9490514609497e-06,0.0105026833643876
1025,907,5165.9089209,0,0,0,0,5.31640580447856e-07,0.00302293905823821
1026,923,15528.40999133,0,0,0,0,1.96982819034019e-06,0.00681857948856456
1027,928,4890.99725137,0,0,0,0,6.90568413119763e-07,0.00364316164592935
1028,929,4580.41035595,0,0,0,0,5.42321686225478e-07,0.00306553328545099
1029,936,10496.87241289,0,0,0,0,9.14280462893657e-07,0.00421436846960614
1030,955,13933.92092466,0,0,0,0,1.4507886589854e-06,0.00571875191534544
1031,957,15175.66125041,0,0,0,0,2.03806439458276e-06,0.00621017897357143
1032,963,4519.77716114,0,0,0,0,4.87024863105034e-07,0.00383435302784295
1033,966,9878.49212459,0,0,0,0,2.2525159693032e-06,0.0092237389184464
1034,971,10969.61966278,0,0,0,0,1.52957727550529e-06,0.00593040515212615
1035,983,15508.36091536,0,0,0,0,1.80184133569128e-06,0.00701705023674749
1036,987,36435.05602362,0,0,0,0,3.69595272786682e-06,0.0136103165256815
1037,997,41545.14354449,0,0,0,0,3.54112808054197e-06,0.0095147562496403
1038,1007,1255.36966642,0,0,0,0,3.04208788293181e-06,0.00667910875244817
1039,1009,13352.69092712,0,0,0,0,1.40241490953485e-06,0.00553435773104075
1040,1010,25755.92629949,0,0,0,0,1.40915926749585e-06,0.00548062898267549
1041,1042,8806.99005777,0,0,0,0,1.22262690638308e-06,0.00439830512396407
1042,1048,4953.50313508,0,0,0,0,5.20225512445904e-07,0.00296596006079451
1043,1210,40677.64554187,1,0,1,0,7.85349584475625e-07,0.00360800186975061
1044,1215,35.3956953,0,0,0,0,4.97218479722505e-07,0.00322667716800738
1045,1119,4007.99463437,0,0,0,0,1.11532017399441e-06,0.00433103768854702
1046,1124,3074.05484874,0,0,0,0,1.22078927233815e-06,0.00729838877025263
1047,1125,8118.50469794,0,0,0,0,3.0631385925517e-06,0.00760232817319436
1048,1128,9053.59336113,0,0,0,0,2.90784055323456e-06,0.00828601176898089
1049,1129,8748.51381945,0,0,0,0,2.62036337517202e-06,0.00791680451224758
1050,1130,13178.71138108,0,0,0,0,4.0456961869495e-06,0.00972837978285513
1051,1131,9945.34832481,0,0,0,0,3.12921019940404e-06,0.00980910746761297
1052,1145,9048.30594477,0,0,0,0,2.61639070231467e-06,0.00812218231481786
1053,1146,9703.8002623,0,0,0,0,2.80107587968814e-06,0.00840911638305552
1054,1147,6721.66141916,0,0,0,0,1.9884028006345e-06,0.00595918216171383
1055,1343,49076.23882874,2,0,2,0,9.64747869147686e-07,0.00410323711202613
1056,1347,9379.17780127,1,0,1,0,3.74694536731113e-07,0.00303417715367352
1057,1350,44065.34946964,0,0,0,0,7.22046024748124e-07,0.00596665549543131
1058,1348,4188.54931666,0,0,0,0,5.91656316828448e-07,0.00447608397942002
1059,1026,7131.21807913,0,0,0,0,5.81324002268957e-07,0.00324838672454924
1060,962,27717.55470597,0,0,0,0,2.37131689573289e-06,0.00680280764406641
1061,412,12250.93438085,0,0,0,0,2.79501364275347e-07,0.00236676748599994
1062,410,17480.23574468,0,0,0,0,5.7919169194065e-07,0.00301933963539673
1063,377,6454.78694126,0,0,0,0,5.86229361942969e-07,0.00314246867722032
1064,356,27837.51024032,0,0,0,0,4.05376795242773e-07,0.00252486945549104
1065,334,7333.28264318,0,0,0,0,2.49711774813477e-07,0.00207689120462543
1066,310,20620.55052042,0,0,0,0,1.02141393654165e-06,0.00569219217946409
1067,312,40452.24998054,0,0,0,0,1.5028044799692e-06,0.00783379047272345
1068,311,7534.49518076,0,0,0,0,2.91692231257912e-07,0.00282938512807572
1069,309,24567.43059546,0,0,0,0,2.47551088250475e-06,0.00759673514967809
1070,443,10501.42779362,0,0,0,0,7.79030415287707e-07,0.00347692338036243
1071,426,2184.63214642,0,0,0,0,1.81246377906064e-07,0.00202376023654517
1072,236,40477.09305984,0,0,0,0,1.33471439767163e-06,0.00472114166472671
1073,1203,9332.00334956,0,0,0,0,4.94581854582066e-07,0.00291017345481265
1074,1085,4380.37849962,0,0,0,0,3.7110203265911e-07,0.00325638869993808
1075,1376,18956.93410008,0,0,0,0,1.17740864880034e-06,0.00863425287098384
1076,99,,0,0,0,0,3.82337020710111e-07,0.00292427381548013
1077,197,,0,0,0,0,1.1851366252813e-06,0.00448701358884013
1078,663,,0,0,0,0,3.22826508636354e-07,0.00334786028992485
1079,1079,,0,0,0,0,1.11310464490089e-06,0.00459405866314523
1080,1253,,0,0,0,0,1.93148844118696e-06,0.00596376131209207
1081,1235,,0,0,0,0,3.00055944535416e-07,0.002161708218897
1082,1327,,0,0,0,0,7.61941464588745e-07,0.00421659589404785
1083,1362,,0,0,0,0,3.33927346218843e-07,0.00226229574930901
1084,1363,,0,0,0,0,5.28216332895681e-07,0.00360144274229991
1085,1361,,0,0,0,0,3.16385467158398e-07,0.00230482691579714
1086,559,,0,0,0,0,1.9535673345672e-07,0.00181400747964951
1087,3,,0,0,0,0,1.25036876852391e-07,0.00234833001725992
1088,506,,0,0,0,0,7.8896846389398e-08,0.00155579220594929
1089,994,,0,0,0,0,4.74318812848651e-06,0.0103911138771868
1090,996,,0,0,0,0,7.57381258154055e-07,0.0046560098833636
1091,1254,,0,0,0,0,2.17729757423513e-06,0.00769430232805836
1092,1162,,0,0,0,0,8.59895862959092e-07,0.00397737754123229
1093,1346,,0,0,0,0,2.77254548564088e-06,0.0100971907342616
1094,1344,,0,0,0,0,6.01113697484834e-07,0.00319156833473561
1095,92,,0,0,0,0,7.42670636100229e-08,0.00116108678351053
1096,397,,0,0,0,0,4.53711891168496e-07,0.00363427677235441
1097,146,,0,0,0,0,1.50264077092288e-06,0.00809172087033084
1098,202,,0,0,0,0,1.1950892258028e-06,0.00735952048896093
1099,1302,,0,0,0,0,2.80381982520339e-06,0.00713938854049115
1100,1303,,0,0,0,0,2.4052301341726e-06,0.00659595648494061
1101,1232,,0,0,0,0,3.91114554076921e-07,0.00255928268434263
1102,1375,,0,0,0,0,4.66418759970111e-06,0.0143930112237793
1103,1374,,0,0,0,0,2.08563460546429e-06,0.00602921063504275
